AAAAAAGTCACAAGGACAT -> AAAAAGTCACAAGGACATT
AAAAAGTCACAAGGACATT -> AAAAGTCACAAGGACATTC
AAAAGAATCCAAGATGCAT -> AAAGAATCCAAGATGCATG
AAAAGATGACCACGCTTAC -> AAAGATGACCACGCTTACG
AAAAGGCCCCAATCGAAAT -> AAAGGCCCCAATCGAAATA
AAAAGGCGATCGTATATTT -> AAAGGCGATCGTATATTTA
AAAAGTCACAAGGACATTC -> AAAGTCACAAGGACATTCG
AAAATACTACCTAAGGATA -> AAATACTACCTAAGGATAG
AAAATCTCAGCATAGGACT -> AAATCTCAGCATAGGACTT
AAACAAGAAGACTTTCGCT -> AACAAGAAGACTTTCGCTA
AAACAGGCGAGACGACCAG -> AACAGGCGAGACGACCAGG
AAACAGTCCCAGGGCCACT -> AACAGTCCCAGGGCCACTC
AAACGTTGAGTCGCTTATT -> AACGTTGAGTCGCTTATTG
AAACTGGGAGCGGCAGATC -> AACTGGGAGCGGCAGATCG
AAACTGTTATCTGAACAAT -> AACTGTTATCTGAACAATT
AAACTGTTATCTGAACACG -> AACTGTTATCTGAACACGG
AAACTGTTATCTGAACAGC -> AACTGTTATCTGAACAGCG
AAACTGTTATCTGAACATC -> AACTGTTATCTGAACATCG
AAAGAATCCAAGATGCATG -> AAGAATCCAAGATGCATGG
AAAGACGATAAATAATTTT -> AAGACGATAAATAATTTTG
AAAGATGACCACGCTTACG -> AAGATGACCACGCTTACGC
AAAGGCCCCAATCGAAATA -> AAGGCCCCAATCGAAATAG
AAAGGCGATCGTATATTTA -> AAGGCGATCGTATATTTAT
AAAGGTGGATGTCGCACAC -> AAGGTGGATGTCGCACACA
AAAGTCACAAGGACATTCG -> AAGTCACAAGGACATTCGG
AAATAATTTTGGCGGTATA -> AATAATTTTGGCGGTATAC
AAATACTACCTAAGGATAG -> AATACTACCTAAGGATAGG
AAATAGCAATTTTAAGATC -> AATAGCAATTTTAAGATCA
AAATCTCACTGGATACGCC -> AATCTCACTGGATACGCCA
AAATCTCAGCATAGGACTT -> AATCTCAGCATAGGACTTG
AAATGTAGATTCCTTCTGT -> AATGTAGATTCCTTCTGTG
AAATTGCGGCATCGACGTT -> AATTGCGGCATCGACGTTG
AACAAGAAGACTTTCGCTA -> ACAAGAAGACTTTCGCTAC
AACAATTAAGGTTCTAGAC -> ACAATTAAGGTTCTAGACT
AACACGGACTCCATAAGAC -> ACACGGACTCCATAAGACT
AACAGCGTACAGACGAGAC -> ACAGCGTACAGACGAGACT
AACAGCGTTTATGGGCGGT -> ACAGCGTTTATGGGCGGTC
AACAGGCGAGACGACCAGG -> ACAGGCGAGACGACCAGGT
AACAGGGTAGATCCTCGTA -> ACAGGGTAGATCCTCGTAG
AACAGGGTTCCAAGAATTA -> ACAGGGTTCCAAGAATTAG
AACAGTCCCAGGGCCACTC -> ACAGTCCCAGGGCCACTCG
AACATCGTGGAGCCAAGAC -> ACATCGTGGAGCCAAGACT
AACATTGAACGTACAGAGG -> ACATTGAACGTACAGAGGC
AACATTGGATAATCCTTCC -> ACATTGGATAATCCTTCCC
AACCACTCTGATAGTGTAC -> ACCACTCTGATAGTGTACT
AACCATAAACAGTCCCAGG -> ACCATAAACAGTCCCAGGG
AACCGAAAAGAATCCAAGA -> ACCGAAAAGAATCCAAGAT
AACCTCCCATCTGTTTAAC -> ACCTCCCATCTGTTTAACT
AACGCAAGCTAACTTTCAC -> ACGCAAGCTAACTTTCACG
AACGCGTCCCCAAGTGTGC -> ACGCGTCCCCAAGTGTGCA
AACGGAGCCTTAACGGTAG -> ACGGAGCCTTAACGGTAGT
AACGGTAGTCCTTCGTTCA -> ACGGTAGTCCTTCGTTCAA
AACGGTCATGAAGAGTATA -> ACGGTCATGAAGAGTATAT
AACGTACAGAGGCGAAGAT -> ACGTACAGAGGCGAAGATG
AACGTTGAGTCGCTTATTG -> ACGTTGAGTCGCTTATTGA
AACTAACAGGGTTCCAAGA -> ACTAACAGGGTTCCAAGAA
AACTCCACAACGCGTCCCC -> ACTCCACAACGCGTCCCCA
AACTCTAGTGACTATGGAT -> ACTCTAGTGACTATGGATT
AACTGAGAGGACCTTCGCT -> ACTGAGAGGACCTTCGCTT
AACTGGGAGCGGCAGATCG -> ACTGGGAGCGGCAGATCGG
AACTGTTATCTGAACAATT -> ACTGTTATCTGAACAATTA
AACTGTTATCTGAACACGG -> ACTGTTATCTGAACACGGA
AACTGTTATCTGAACAGCG -> ACTGTTATCTGAACAGCGT
AACTGTTATCTGAACATCG -> ACTGTTATCTGAACATCGT
AACTTGATCTGACGCTGCT -> ACTTGATCTGACGCTGCTG
AACTTTCACGCGTTAATAG -> ACTTTCACGCGTTAATAGG
AAGAACAGGGTAGATCCTC -> AGAACAGGGTAGATCCTCG
AAGAACCGAAAAGAATCCA -> AGAACCGAAAAGAATCCAA
AAGAAGACTTTCGCTACCA -> AGAAGACTTTCGCTACCAT
AAGAATCCAAGATGCATGG -> AGAATCCAAGATGCATGGC
AAGAATCTCCGAAGGCACG -> AGAATCTCCGAAGGCACGC
AAGAATTAGCCATGGCGCC -> AGAATTAGCCATGGCGCCT
AAGACCCAAATCTCACTGG -> AGACCCAAATCTCACTGGA
AAGACGATAAATAATTTTG -> AGACGATAAATAATTTTGG
AAGACTTGGTGCATCGCTA -> AGACTTGGTGCATCGCTAA,AGACTTGGTGCATCGCTAA
AAGACTTTCGCTACCATCG -> AGACTTTCGCTACCATCGT
AAGAGTATATCCAGAGACG -> AGAGTATATCCAGAGACGC
AAGATCAGAATCAGAGCAA -> AGATCAGAATCAGAGCAAC
AAGATGACCACGCTTACGC -> AGATGACCACGCTTACGCT
AAGATGCATGGCGACTGAT -> AGATGCATGGCGACTGATG
AAGATGTCACGGCCAAACT -> AGATGTCACGGCCAAACTG
AAGCCGTACCCTGGACCAA -> AGCCGTACCCTGGACCAAG
AAGCCTATGTCAATTCAGC -> AGCCTATGTCAATTCAGCC
AAGCGAATCCAGTTACGCT -> AGCGAATCCAGTTACGCTG
AAGCGCAGCTTTTACCTTG -> AGCGCAGCTTTTACCTTGC
AAGCGGAGTTCCCGGGTTT -> AGCGGAGTTCCCGGGTTTC
AAGCTAACTTTCACGCGTT -> AGCTAACTTTCACGCGTTA
AAGCTGTTGTCGTACTATC -> AGCTGTTGTCGTACTATCA
AAGGACATTCGGAGTGGAT -> AGGACATTCGGAGTGGATA
AAGGATAGGGGGTAATTAA -> AGGATAGGGGGTAATTAAC
AAGGATTCTAAACAGGCGA -> AGGATTCTAAACAGGCGAG
AAGGCAAAATACTACCTAA -> AGGCAAAATACTACCTAAG
AAGGCACGCTTTCTCCATC -> AGGCACGCTTTCTCCATCG
AAGGCCCCAATCGAAATAG -> AGGCCCCAATCGAAATAGC
AAGGCGATCGTATATTTAT -> AGGCGATCGTATATTTATG
AAGGGATCTGGGGGGCCCC -> AGGGATCTGGGGGGCCCCT
AAGGTCTAGGCCGCCTTTC -> AGGTCTAGGCCGCCTTTCC
AAGGTGGATGTCGCACACA -> AGGTGGATGTCGCACACAG
AAGGTGTGCTCTCTGACAT -> AGGTGTGCTCTCTGACATG
AAGGTTCTAGACTTGGTGC -> AGGTTCTAGACTTGGTGCA
AAGTCACAAGGACATTCGG -> AGTCACAAGGACATTCGGA
AAGTCATGGAGGCCAACAT -> AGTCATGGAGGCCAACATT
AAGTCGGTCTATCGCACCG -> AGTCGGTCTATCGCACCGA
AAGTCTTTGTAGAGGGACG -> AGTCTTTGTAGAGGGACGA
AAGTGCTCGCCGCACGCCC -> AGTGCTCGCCGCACGCCCT
AAGTGTGCATATCAAGTTC -> AGTGTGCATATCAAGTTCC
AAGTGTTCAGGAGGCATCT -> AGTGTTCAGGAGGCATCTG
AAGTTCCTGCGAAGGATTC -> AGTTCCTGCGAAGGATTCT
AATAACGGTCATGAAGAGT -> ATAACGGTCATGAAGAGTA
AATAAGTGTTCAGGAGGCA -> ATAAGTGTTCAGGAGGCAT
AATAATTTTGGCGGTATAC -> ATAATTTTGGCGGTATACG
AATACGATTTTGCGAAAAG -> ATACGATTTTGCGAAAAGG
AATACTACCTAAGGATAGG -> ATACTACCTAAGGATAGGG
AATAGCAATTTTAAGATCA -> ATAGCAATTTTAAGATCAG
AATAGGTGATTTGTTAATC -> ATAGGTGATTTGTTAATCG
AATCAGAGCAACATTGAAC -> ATCAGAGCAACATTGAACG
AATCAGCACATGATTTCGG -> ATCAGCACATGATTTCGGG
AATCAGTCACATTACAGAT -> ATCAGTCACATTACAGATT
AATCCAAGATGCATGGCGA -> ATCCAAGATGCATGGCGAC
AATCCAGTTACGCTGACCT -> ATCCAGTTACGCTGACCTA
AATCCTTCCCAGGAGTCAG -> ATCCTTCCCAGGAGTCAGG
AATCGAAATAGCAATTTTA -> ATCGAAATAGCAATTTTAA
AATCGGCTGCTCTGGGGCG -> ATCGGCTGCTCTGGGGCGA
AATCTCACTGGATACGCCA -> ATCTCACTGGATACGCCAG
AATCTCAGCATAGGACTTG -> ATCTCAGCATAGGACTTGT
AATCTCCGAAGGCACGCTT -> ATCTCCGAAGGCACGCTTT
AATCTTCGCGATCTTAGTG -> ATCTTCGCGATCTTAGTGG
AATGACACCATAATCTTCG -> ATGACACCATAATCTTCGC
AATGATCAGCCTCATCTGG -> ATGATCAGCCTCATCTGGA
AATGGAAACAAGAAGACTT -> ATGGAAACAAGAAGACTTT
AATGTAGATTCCTTCTGTG -> ATGTAGATTCCTTCTGTGC
AATTAACCACTCTGATAGT -> ATTAACCACTCTGATAGTG
AATTAAGGTTCTAGACTTG -> ATTAAGGTTCTAGACTTGG
AATTAGCCATGGCGCCTAC -> ATTAGCCATGGCGCCTACC
AATTCAGCCGGTTATAGCG -> ATTCAGCCGGTTATAGCGC
AATTGCGGCATCGACGTTG -> ATTGCGGCATCGACGTTGG
AATTTTAAGATCAGAATCA -> ATTTTAAGATCAGAATCAG
AATTTTGGCGGTATACGCT -> ATTTTGGCGGTATACGCTG
ACAAACTGTTATCTGAACA -> CAAACTGTTATCTGAACAA
ACAACGCGTCCCCAAGTGT -> CAACGCGTCCCCAAGTGTG
ACAAGAACAGGGTAGATCC -> CAAGAACAGGGTAGATCCT
ACAAGAAGACTTTCGCTAC -> CAAGAAGACTTTCGCTACC
ACAAGCCTATGTCAATTCA -> CAAGCCTATGTCAATTCAG
ACAAGGACATTCGGAGTGG -> CAAGGACATTCGGAGTGGA
ACAATGATCAGCCTCATCT -> CAATGATCAGCCTCATCTG
ACAATTAAGGTTCTAGACT -> CAATTAAGGTTCTAGACTT
ACACAATGATCAGCCTCAT -> CACAATGATCAGCCTCATC
ACACAGGTGACGTGGTCAA -> CACAGGTGACGTGGTCAAG
ACACCATAATCTTCGCGAT -> CACCATAATCTTCGCGATC
ACACCGGGTATATAGCTAC -> CACCGGGTATATAGCTACC
ACACGGACTCCATAAGACT -> CACGGACTCCATAAGACTT
ACACTCCGGTGATGAAAAG -> CACTCCGGTGATGAAAAGG
ACACTGGTCACCAATAACG -> CACTGGTCACCAATAACGG
ACAGACGAGACTTGGTGCA -> CAGACGAGACTTGGTGCAT
ACAGAGGCGAAGATGTCAC -> CAGAGGCGAAGATGTCACG
ACAGATTGCGGTAAGTGCT -> CAGATTGCGGTAAGTGCTC
ACAGCGCGCTTCCGTTTCA -> CAGCGCGCTTCCGTTTCAG
ACAGCGTACAGACGAGACT -> CAGCGTACAGACGAGACTT
ACAGCGTTTATGGGCGGTC -> CAGCGTTTATGGGCGGTCA
ACAGGCGAGACGACCAGGT -> CAGGCGAGACGACCAGGTT
ACAGGGTAGATCCTCGTAG -> CAGGGTAGATCCTCGTAGG
ACAGGGTTCCAAGAATTAG -> CAGGGTTCCAAGAATTAGC
ACAGGTGACGTGGTCAAGA -> CAGGTGACGTGGTCAAGAA
ACAGTCCCAGGGCCACTCG -> CAGTCCCAGGGCCACTCGG
ACATACGGACGTCGTGCGA -> CATACGGACGTCGTGCGAT
ACATCCCCCAGCGAGTAAG -> CATCCCCCAGCGAGTAAGC
ACATCCCTATCGGCAGATC -> CATCCCTATCGGCAGATCG
ACATCGTGGAGCCAAGACT -> CATCGTGGAGCCAAGACTT
ACATGATTTCGGGGATCCA -> CATGATTTCGGGGATCCAT
ACATGTAAGTCATGGAGGC -> CATGTAAGTCATGGAGGCC
ACATTACAGATTGCGGTAA -> CATTACAGATTGCGGTAAG
ACATTCGGAGTGGATAAAT -> CATTCGGAGTGGATAAATG
ACATTGAACGTACAGAGGC -> CATTGAACGTACAGAGGCG
ACATTGGATAATCCTTCCC -> CATTGGATAATCCTTCCCA
ACCAAGGCAAAATACTACC -> CCAAGGCAAAATACTACCT
ACCAATAACGGTCATGAAG -> CCAATAACGGTCATGAAGA
ACCACGCTTACGCTTCACT -> CCACGCTTACGCTTCACTT
ACCACGTAAGCCGTACCCT -> CCACGTAAGCCGTACCCTG
ACCACTCTGATAGTGTACT -> CCACTCTGATAGTGTACTA
ACCAGGTTCCACAAACTGT -> CCAGGTTCCACAAACTGTT
ACCAGTCCGCCTTAGCGAT -> CCAGTCCGCCTTAGCGATG
ACCATAAACAGTCCCAGGG -> CCATAAACAGTCCCAGGGC
ACCATAATCTTCGCGATCT -> CCATAATCTTCGCGATCTT
ACCATCGTGCGCATTCTTG -> CCATCGTGCGCATTCTTGA
ACCCAAATCTCACTGGATA -> CCCAAATCTCACTGGATAC
ACCCAACTAACAGGGTTCC -> CCCAACTAACAGGGTTCCA
ACCCCGCATAGTAAGACCC -> CCCCGCATAGTAAGACCCA
ACCCTAACGCAAGCTAACT -> CCCTAACGCAAGCTAACTT
ACCCTGGACCAAGGCAAAA -> CCCTGGACCAAGGCAAAAT
ACCCTTGGCAGACTCGTGT -> CCCTTGGCAGACTCGTGTA
ACCGAAAAGAATCCAAGAT -> CCGAAAAGAATCCAAGATG
ACCGAAAGGTGGATGTCGC -> CCGAAAGGTGGATGTCGCA
ACCGAGATCAAGGGATCTG -> CCGAGATCAAGGGATCTGG
ACCGGGTATATAGCTACCT -> CCGGGTATATAGCTACCTC
ACCGTCGAGACACTGGTCA -> CCGTCGAGACACTGGTCAC
ACCTAAGGATAGGGGGTAA -> CCTAAGGATAGGGGGTAAT
ACCTAGGTTGATTGCGGGA -> CCTAGGTTGATTGCGGGAT
ACCTATATGCGATTTGCCT -> CCTATATGCGATTTGCCTC
ACCTCAAAGACGATAAATA -> CCTCAAAGACGATAAATAA
ACCTCCCATCTGTTTAACT -> CCTCCCATCTGTTTAACTT
ACCTTCGCTTCTTCTGATA -> CCTTCGCTTCTTCTGATAT
ACCTTGCGGTGGGTTAGTA -> CCTTGCGGTGGGTTAGTAA
ACGACCAGGTTCCACAAAC -> CGACCAGGTTCCACAAACT
ACGAGACTTGGTGCATCGC -> CGAGACTTGGTGCATCGCT
ACGATAAATAATTTTGGCG -> CGATAAATAATTTTGGCGG
ACGATCTCGAACCTCCCAT -> CGATCTCGAACCTCCCATC
ACGATTTTGCGAAAAGGCG -> CGATTTTGCGAAAAGGCGA
ACGCAAGCTAACTTTCACG -> CGCAAGCTAACTTTCACGC
ACGCACTTATACTTAGCAC -> CGCACTTATACTTAGCACT
ACGCCAATACGATTTTGCG -> CGCCAATACGATTTTGCGA
ACGCCACAAGAACAGGGTA -> CGCCACAAGAACAGGGTAG
ACGCCAGGAAGCTGTTGTC -> CGCCAGGAAGCTGTTGTCG
ACGCCCTGCGACTCACCTA -> CGCCCTGCGACTCACCTAG
ACGCGTCCCCAAGTGTGCA -> CGCGTCCCCAAGTGTGCAT
ACGCGTTAATAGGTGATTT -> CGCGTTAATAGGTGATTTG
ACGCTGACACAATGATCAG -> CGCTGACACAATGATCAGC
ACGCTGACCTATATGCGAT -> CGCTGACCTATATGCGATT
ACGCTGCCGTAAAAAAGTC -> CGCTGCCGTAAAAAAGTCA
ACGCTGCTGCCTATTAATG -> CGCTGCTGCCTATTAATGG
ACGCTGGGTTCACGCCAAT -> CGCTGGGTTCACGCCAATA
ACGCTTACGCTTCACTTGC -> CGCTTACGCTTCACTTGCG
ACGCTTCACTTGCGACACC -> CGCTTCACTTGCGACACCG
ACGCTTTCTCCATCGGAGG -> CGCTTTCTCCATCGGAGGA
ACGGACGTCGTGCGATGCA -> CGGACGTCGTGCGATGCAT
ACGGACTCCATAAGACTTG -> CGGACTCCATAAGACTTGG
ACGGAGCCTTAACGGTAGT -> CGGAGCCTTAACGGTAGTC
ACGGCCAAACTGTTATCTG -> CGGCCAAACTGTTATCTGA
ACGGTAGTCCTTCGTTCAA -> CGGTAGTCCTTCGTTCAAA
ACGGTCATGAAGAGTATAT -> CGGTCATGAAGAGTATATC
ACGGTCTATTGAGCGCTAA -> CGGTCTATTGAGCGCTAAG
ACGTAAGCCGTACCCTGGA -> CGTAAGCCGTACCCTGGAC
ACGTACAGAGGCGAAGATG -> CGTACAGAGGCGAAGATGT
ACGTAGATACAAGCCTATG -> CGTAGATACAAGCCTATGT
ACGTATAACAGCGTTTATG -> CGTATAACAGCGTTTATGG
ACGTCACCGAGATCAAGGG -> CGTCACCGAGATCAAGGGA
ACGTCGTGCGATGCATACC -> CGTCGTGCGATGCATACCC
ACGTGGTCAAGAACCGAAA -> CGTGGTCAAGAACCGAAAA
ACGTTGAGTCGCTTATTGA -> CGTTGAGTCGCTTATTGAT
ACGTTGGACATCCCCCAGC -> CGTTGGACATCCCCCAGCG
ACTAACAGGGTTCCAAGAA -> CTAACAGGGTTCCAAGAAT
ACTACCTAAGGATAGGGGG -> CTACCTAAGGATAGGGGGT
ACTATCATTGGGGAGACAT -> CTATCATTGGGGAGACATA
ACTATGGATTCGTAATGAC -> CTATGGATTCGTAATGACA
ACTATTCGCTAACCATAAA -> CTATTCGCTAACCATAAAC
ACTATTTGGATTTTTGGGG -> CTATTTGGATTTTTGGGGG
ACTCACCTAGGTTGATTGC -> CTCACCTAGGTTGATTGCG
ACTCCACAACGCGTCCCCA -> CTCCACAACGCGTCCCCAA
ACTCCAGACAGCGCGCTTC -> CTCCAGACAGCGCGCTTCC
ACTCCATAAGACTTGGTGC -> CTCCATAAGACTTGGTGCA
ACTCCGGTGATGAAAAGGC -> CTCCGGTGATGAAAAGGCC
ACTCGCCAGCAAAATCTCA -> CTCGCCAGCAAAATCTCAG
ACTCGGGACTCGTAGCGAG -> CTCGGGACTCGTAGCGAGC
ACTCGTAGCGAGCGGATTA -> CTCGTAGCGAGCGGATTAG
ACTCGTGTAGGAGTCCTCA -> CTCGTGTAGGAGTCCTCAA
ACTCTAGTGACTATGGATT -> CTCTAGTGACTATGGATTC
ACTCTGATAGTGTACTATT -> CTCTGATAGTGTACTATTT
ACTGAGAGGACCTTCGCTT -> CTGAGAGGACCTTCGCTTC
ACTGATGTGTAACTCTAGT -> CTGATGTGTAACTCTAGTG
ACTGGATACGCCAGGAAGC -> CTGGATACGCCAGGAAGCT
ACTGGCTTGCGGCAAACTG -> CTGGCTTGCGGCAAACTGT
ACTGGGAGCGGCAGATCGG -> CTGGGAGCGGCAGATCGGC
ACTGGGTTCAAGGTGTGCT -> CTGGGTTCAAGGTGTGCTC
ACTGGTCACCAATAACGGT -> CTGGTCACCAATAACGGTC
ACTGTTATCTGAACAATTA -> CTGTTATCTGAACAATTAA
ACTGTTATCTGAACACGGA -> CTGTTATCTGAACACGGAC
ACTGTTATCTGAACAGCGT -> CTGTTATCTGAACAGCGTA
ACTGTTATCTGAACATCGT -> CTGTTATCTGAACATCGTG
ACTTAGCACTCCAGACAGC -> CTTAGCACTCCAGACAGCG
ACTTATACTTAGCACTCCA -> CTTATACTTAGCACTCCAG
ACTTCCCTAGATCATGCGA -> CTTCCCTAGATCATGCGAA
ACTTGATCTGACGCTGCTG -> CTTGATCTGACGCTGCTGC
ACTTGCGACACCGGGTATA -> CTTGCGACACCGGGTATAT
ACTTGGTGCATCGCTAAAC -> CTTGGTGCATCGCTAAACT,CTTGGTGCATCGCTAAACG
ACTTGGTGCATCGCTAAGC -> CTTGGTGCATCGCTAAGCG
ACTTGGTGCATCGCTAATA -> CTTGGTGCATCGCTAATAA
ACTTGTAGTGTGAGGACTT -> CTTGTAGTGTGAGGACTTT
ACTTTCACGCGTTAATAGG -> CTTTCACGCGTTAATAGGT
ACTTTCCCCTTGGCCTTTA -> CTTTCCCCTTGGCCTTTAA
ACTTTCGCTACCATCGTGC -> CTTTCGCTACCATCGTGCG
AGAACAGGGTAGATCCTCG -> GAACAGGGTAGATCCTCGT
AGAACCGAAAAGAATCCAA -> GAACCGAAAAGAATCCAAG
AGAAGACTTTCGCTACCAT -> GAAGACTTTCGCTACCATC
AGAATCAGAGCAACATTGA -> GAATCAGAGCAACATTGAA
AGAATCCAAGATGCATGGC -> GAATCCAAGATGCATGGCG
AGAATCTCCGAAGGCACGC -> GAATCTCCGAAGGCACGCT
AGAATTAGCCATGGCGCCT -> GAATTAGCCATGGCGCCTA
AGACACTGGTCACCAATAA -> GACACTGGTCACCAATAAC
AGACAGCGCGCTTCCGTTT -> GACAGCGCGCTTCCGTTTC
AGACATACGGACGTCGTGC -> GACATACGGACGTCGTGCG
AGACCCAAATCTCACTGGA -> GACCCAAATCTCACTGGAT
AGACGACCAGGTTCCACAA -> GACGACCAGGTTCCACAAA
AGACGAGACTTGGTGCATC -> GACGAGACTTGGTGCATCG
AGACGATAAATAATTTTGG -> GACGATAAATAATTTTGGC
AGACGCACTTATACTTAGC -> GACGCACTTATACTTAGCA
AGACGTAGATACAAGCCTA -> GACGTAGATACAAGCCTAT
AGACTCGTGTAGGAGTCCT -> GACTCGTGTAGGAGTCCTC
AGACTTGGTGCATCGCTAA -> GACTTGGTGCATCGCTAAA,GACTTGGTGCATCGCTAAG,GACTTGGTGCATCGCTAAT,GACTTGGTGCATCGCTAAA
AGACTTTCGCTACCATCGT -> GACTTTCGCTACCATCGTG
AGAGACGCACTTATACTTA -> GAGACGCACTTATACTTAG
AGAGCAACATTGAACGTAC -> GAGCAACATTGAACGTACA
AGAGGACCTTCGCTTCTTC -> GAGGACCTTCGCTTCTTCT
AGAGGCGAAGATGTCACGG -> GAGGCGAAGATGTCACGGC
AGAGGGACGATCTCGAACC -> GAGGGACGATCTCGAACCT
AGAGTATATCCAGAGACGC -> GAGTATATCCAGAGACGCA
AGATACAAGCCTATGTCAA -> GATACAAGCCTATGTCAAT
AGATCAAGGGATCTGGGGG -> GATCAAGGGATCTGGGGGG
AGATCAGAATCAGAGCAAC -> GATCAGAATCAGAGCAACA
AGATCATGCGAACTCCACA -> GATCATGCGAACTCCACAA
AGATCCTCGTAGGGGGGTG -> GATCCTCGTAGGGGGGTGT
AGATCGGACTTCCCTAGAT -> GATCGGACTTCCCTAGATC
AGATCGGCGGACGCTGACA -> GATCGGCGGACGCTGACAC
AGATGACCACGCTTACGCT -> GATGACCACGCTTACGCTT
AGATGCATGGCGACTGATG -> GATGCATGGCGACTGATGT
AGATGTCACGGCCAAACTG -> GATGTCACGGCCAAACTGT
AGATTCCTTCTGTGCACAC -> GATTCCTTCTGTGCACACT
AGATTGCGGTAAGTGCTCG -> GATTGCGGTAAGTGCTCGC
AGCAAAATCTCAGCATAGG -> GCAAAATCTCAGCATAGGA
AGCAACATTGAACGTACAG -> GCAACATTGAACGTACAGA
AGCAATTTTAAGATCAGAA -> GCAATTTTAAGATCAGAAT
AGCACATGATTTCGGGGAT -> GCACATGATTTCGGGGATC
AGCACGTATAACAGCGTTT -> GCACGTATAACAGCGTTTA
AGCACTCCAGACAGCGCGC -> GCACTCCAGACAGCGCGCT
AGCATAACTGAGAGGACCT -> GCATAACTGAGAGGACCTT
AGCATAGGACTTGTAGTGT -> GCATAGGACTTGTAGTGTG
AGCCAAGACTTGGTGCATC -> GCCAAGACTTGGTGCATCG
AGCCATGGCGCCTACCCTT -> GCCATGGCGCCTACCCTTG
AGCCGGTTATAGCGCCATA -> GCCGGTTATAGCGCCATAT
AGCCGTACCCTGGACCAAG -> GCCGTACCCTGGACCAAGG
AGCCTATGTCAATTCAGCC -> GCCTATGTCAATTCAGCCG
AGCCTCATCTGGATACGCC -> GCCTCATCTGGATACGCCA
AGCCTTAACGGTAGTCCTT -> GCCTTAACGGTAGTCCTTC
AGCGAATCCAGTTACGCTG -> GCGAATCCAGTTACGCTGA
AGCGAGCGGATTAGACGTA -> GCGAGCGGATTAGACGTAG
AGCGAGTAAGCGCAGCTTT -> GCGAGTAAGCGCAGCTTTT
AGCGATATATCTTGTGTTT -> GCGATATATCTTGTGTTTG
AGCGATGCCTGGACTGGGT -> GCGATGCCTGGACTGGGTT
AGCGCAGCTTTTACCTTGC -> GCGCAGCTTTTACCTTGCG
AGCGCCATATTAGCATAAC -> GCGCCATATTAGCATAACT
AGCGCGCTTCCGTTTCAGT -> GCGCGCTTCCGTTTCAGTA
AGCGCTAAGGTCTAGGCCG -> GCGCTAAGGTCTAGGCCGC
AGCGGAGTTCCCGGGTTTC -> GCGGAGTTCCCGGGTTTCT
AGCGGATTAGACGTAGATA -> GCGGATTAGACGTAGATAC
AGCGGCAGATCGGCGGACG -> GCGGCAGATCGGCGGACGC
AGCGTACAGACGAGACTTG -> GCGTACAGACGAGACTTGG
AGCGTTTATGGGCGGTCAT -> GCGTTTATGGGCGGTCATT
AGCTAACTTTCACGCGTTA -> GCTAACTTTCACGCGTTAA
AGCTACCTCAAAGACGATA -> GCTACCTCAAAGACGATAA
AGCTGTTGTCGTACTATCA -> GCTGTTGTCGTACTATCAT
AGCTTTTACCTTGCGGTGG -> GCTTTTACCTTGCGGTGGG
AGGAAGCTGTTGTCGTACT -> GGAAGCTGTTGTCGTACTA
AGGACATTCGGAGTGGATA -> GGACATTCGGAGTGGATAA
AGGACCTTCGCTTCTTCTG -> GGACCTTCGCTTCTTCTGA
AGGACTGGCTTGCGGCAAA -> GGACTGGCTTGCGGCAAAC
AGGACTTGTAGTGTGAGGA -> GGACTTGTAGTGTGAGGAC
AGGACTTTCCCCTTGGCCT -> GGACTTTCCCCTTGGCCTT
AGGAGGCATCTGTACATCC -> GGAGGCATCTGTACATCCC
AGGAGTCAGGCTAAGTCTT -> GGAGTCAGGCTAAGTCTTT
AGGAGTCCTCAAATTGCGG -> GGAGTCCTCAAATTGCGGC
AGGATAGGGGGTAATTAAC -> GGATAGGGGGTAATTAACC
AGGATTCTAAACAGGCGAG -> GGATTCTAAACAGGCGAGA
AGGATTGGAGCACGTATAA -> GGATTGGAGCACGTATAAC
AGGCAAAATACTACCTAAG -> GGCAAAATACTACCTAAGG
AGGCACGCTTTCTCCATCG -> GGCACGCTTTCTCCATCGG
AGGCATCTGTACATCCCTA -> GGCATCTGTACATCCCTAT
AGGCCAACATTGGATAATC -> GGCCAACATTGGATAATCC
AGGCCCCAATCGAAATAGC -> GGCCCCAATCGAAATAGCA
AGGCCGCCTTTCCCGAGTA -> GGCCGCCTTTCCCGAGTAA
AGGCGAAGATGTCACGGCC -> GGCGAAGATGTCACGGCCA
AGGCGAGACGACCAGGTTC -> GGCGAGACGACCAGGTTCC
AGGCGATCGTATATTTATG -> GGCGATCGTATATTTATGT
AGGCTAAGTCTTTGTAGAG -> GGCTAAGTCTTTGTAGAGG
AGGGACGATCTCGAACCTC -> GGGACGATCTCGAACCTCC
AGGGATCTGGGGGGCCCCT -> GGGATCTGGGGGGCCCCTC
AGGGCCACTCGGGACTCGT -> GGGCCACTCGGGACTCGTA
AGGGGGGTGTACGTCACCG -> GGGGGGTGTACGTCACCGA
AGGGGGTAATTAACCACTC -> GGGGGTAATTAACCACTCT
AGGGTAGATCCTCGTAGGG -> GGGTAGATCCTCGTAGGGG
AGGGTTCCAAGAATTAGCC -> GGGTTCCAAGAATTAGCCA
AGGTCTAGGCCGCCTTTCC -> GGTCTAGGCCGCCTTTCCC
AGGTGACGTGGTCAAGAAC -> GGTGACGTGGTCAAGAACC
AGGTGATTTGTTAATCGGC -> GGTGATTTGTTAATCGGCT
AGGTGGATGTCGCACACAG -> GGTGGATGTCGCACACAGG
AGGTGTGCTCTCTGACATG -> GGTGTGCTCTCTGACATGT
AGGTTCCACAAACTGTTAT -> GGTTCCACAAACTGTTATC
AGGTTCTAGACTTGGTGCA -> GGTTCTAGACTTGGTGCAT
AGGTTGATTGCGGGATGGC -> GGTTGATTGCGGGATGGCA
AGTAAAAGATGACCACGCT -> GTAAAAGATGACCACGCTT
AGTAAGACCCAAATCTCAC -> GTAAGACCCAAATCTCACT
AGTAAGCGCAGCTTTTACC -> GTAAGCGCAGCTTTTACCT
AGTAAGTCGGTCTATCGCA -> GTAAGTCGGTCTATCGCAC
AGTAATCAGTCACATTACA -> GTAATCAGTCACATTACAG
AGTATATCCAGAGACGCAC -> GTATATCCAGAGACGCACT
AGTATTGACCCAACTAACA -> GTATTGACCCAACTAACAG
AGTCACAAGGACATTCGGA -> GTCACAAGGACATTCGGAG
AGTCACATTACAGATTGCG -> GTCACATTACAGATTGCGG
AGTCAGGCTAAGTCTTTGT -> GTCAGGCTAAGTCTTTGTA
AGTCATGGAGGCCAACATT -> GTCATGGAGGCCAACATTG
AGTCCCAGGGCCACTCGGG -> GTCCCAGGGCCACTCGGGA
AGTCCGCCTTAGCGATGCC -> GTCCGCCTTAGCGATGCCT
AGTCCTCAAATTGCGGCAT -> GTCCTCAAATTGCGGCATC
AGTCCTTCGTTCAAACTGT -> GTCCTTCGTTCAAACTGTT
AGTCGCTTATTGATTCTTA -> GTCGCTTATTGATTCTTAT
AGTCGGTCTATCGCACCGA -> GTCGGTCTATCGCACCGAA
AGTCTTTGTAGAGGGACGA -> GTCTTTGTAGAGGGACGAT
AGTGACTATGGATTCGTAA -> GTGACTATGGATTCGTAAT
AGTGCTCGCCGCACGCCCT -> GTGCTCGCCGCACGCCCTG
AGTGGATAAATGTAGATTC -> GTGGATAAATGTAGATTCC
AGTGTACTATTTGGATTTT -> GTGTACTATTTGGATTTTT
AGTGTGAGGACTTTCCCCT -> GTGTGAGGACTTTCCCCTT
AGTGTGCATATCAAGTTCC -> GTGTGCATATCAAGTTCCT
AGTGTTCAGGAGGCATCTG -> GTGTTCAGGAGGCATCTGT
AGTTACGCTGACCTATATG -> GTTACGCTGACCTATATGC
AGTTCCCGGGTTTCTCGTG -> GTTCCCGGGTTTCTCGTGG
AGTTCCTGCGAAGGATTCT -> GTTCCTGCGAAGGATTCTA
ATAAACAGTCCCAGGGCCA -> TAAACAGTCCCAGGGCCAC
ATAAATAATTTTGGCGGTA -> TAAATAATTTTGGCGGTAT
ATAAATGTAGATTCCTTCT -> TAAATGTAGATTCCTTCTG
ATAACAGCGTTTATGGGCG -> TAACAGCGTTTATGGGCGG
ATAACGGTCATGAAGAGTA -> TAACGGTCATGAAGAGTAT
ATAACTGAGAGGACCTTCG -> TAACTGAGAGGACCTTCGC
ATAAGACTTGGTGCATCGC -> TAAGACTTGGTGCATCGCT
ATAAGTGTTCAGGAGGCAT -> TAAGTGTTCAGGAGGCATC
ATAATCCTTCCCAGGAGTC -> TAATCCTTCCCAGGAGTCA
ATAATCTTCGCGATCTTAG -> TAATCTTCGCGATCTTAGT
ATAATTTTGGCGGTATACG -> TAATTTTGGCGGTATACGC
ATACAAGCCTATGTCAATT -> TACAAGCCTATGTCAATTC
ATACCCTAACGCAAGCTAA -> TACCCTAACGCAAGCTAAC
ATACGATTTTGCGAAAAGG -> TACGATTTTGCGAAAAGGC
ATACGCCACAAGAACAGGG -> TACGCCACAAGAACAGGGT
ATACGCCAGGAAGCTGTTG -> TACGCCAGGAAGCTGTTGT
ATACGCTGCCGTAAAAAAG -> TACGCTGCCGTAAAAAAGT
ATACGGACGTCGTGCGATG -> TACGGACGTCGTGCGATGC
ATACTACCTAAGGATAGGG -> TACTACCTAAGGATAGGGG
ATACTTAGCACTCCAGACA -> TACTTAGCACTCCAGACAG
ATAGCAATTTTAAGATCAG -> TAGCAATTTTAAGATCAGA
ATAGCGCCATATTAGCATA -> TAGCGCCATATTAGCATAA
ATAGCTACCTCAAAGACGA -> TAGCTACCTCAAAGACGAT
ATAGGACTTGTAGTGTGAG -> TAGGACTTGTAGTGTGAGG
ATAGGGGGTAATTAACCAC -> TAGGGGGTAATTAACCACT
ATAGGTGATTTGTTAATCG -> TAGGTGATTTGTTAATCGG
ATAGTAAGACCCAAATCTC -> TAGTAAGACCCAAATCTCA
ATAGTAAGTCGGTCTATCG -> TAGTAAGTCGGTCTATCGC
ATAGTGTACTATTTGGATT -> TAGTGTACTATTTGGATTT
ATATAGCTACCTCAAAGAC -> TATAGCTACCTCAAAGACG
ATATATCTTGTGTTTGGGA -> TATATCTTGTGTTTGGGAC
ATATCAAGTTCCTGCGAAG -> TATCAAGTTCCTGCGAAGG
ATATCCAGAGACGCACTTA -> TATCCAGAGACGCACTTAT
ATATCTTGTGTTTGGGACC -> TATCTTGTGTTTGGGACCA
ATATGCGATTTGCCTCCGT -> TATGCGATTTGCCTCCGTC
ATATTAGCATAACTGAGAG -> TATTAGCATAACTGAGAGG
ATATTGAGGATTGGAGCAC -> TATTGAGGATTGGAGCACG
ATATTTATGTCAGCGATAT -> TATTTATGTCAGCGATATA
ATCAAGGGATCTGGGGGGC -> TCAAGGGATCTGGGGGGCC
ATCAAGTTCCTGCGAAGGA -> TCAAGTTCCTGCGAAGGAT
ATCAGAATCAGAGCAACAT -> TCAGAATCAGAGCAACATT
ATCAGAGCAACATTGAACG -> TCAGAGCAACATTGAACGT
ATCAGCACATGATTTCGGG -> TCAGCACATGATTTCGGGG
ATCAGCCTCATCTGGATAC -> TCAGCCTCATCTGGATACG
ATCAGTCACATTACAGATT -> TCAGTCACATTACAGATTG
ATCATGCGAACTCCACAAC -> TCATGCGAACTCCACAACG
ATCATTGGGGAGACATACG -> TCATTGGGGAGACATACGG
ATCCAAGATGCATGGCGAC -> TCCAAGATGCATGGCGACT
ATCCAGAGACGCACTTATA -> TCCAGAGACGCACTTATAC
ATCCAGTTACGCTGACCTA -> TCCAGTTACGCTGACCTAT
ATCCATCCTCCGTTATAGT -> TCCATCCTCCGTTATAGTA
ATCCCCCAGCGAGTAAGCG -> TCCCCCAGCGAGTAAGCGC
ATCCCTATCGGCAGATCGG -> TCCCTATCGGCAGATCGGA
ATCCTCCGTTATAGTAAGT -> TCCTCCGTTATAGTAAGTC
ATCCTCGTAGGGGGGTGTA -> TCCTCGTAGGGGGGTGTAC
ATCCTTCCCAGGAGTCAGG -> TCCTTCCCAGGAGTCAGGC
ATCGAAATAGCAATTTTAA -> TCGAAATAGCAATTTTAAG
ATCGACGTTGGACATCCCC -> TCGACGTTGGACATCCCCC
ATCGCACCGAAAGGTGGAT -> TCGCACCGAAAGGTGGATG
ATCGCTAAACGTTGAGTCG -> TCGCTAAACGTTGAGTCGC
ATCGCTAAACTGGGAGCGG -> TCGCTAAACTGGGAGCGGC
ATCGCTAAGCGGAGTTCCC -> TCGCTAAGCGGAGTTCCCG
ATCGCTAATAAGTGTTCAG -> TCGCTAATAAGTGTTCAGG
ATCGGACTTCCCTAGATCA -> TCGGACTTCCCTAGATCAT
ATCGGAGGACTGGCTTGCG -> TCGGAGGACTGGCTTGCGG
ATCGGCAGATCGGACTTCC -> TCGGCAGATCGGACTTCCC
ATCGGCGGACGCTGACACA -> TCGGCGGACGCTGACACAA
ATCGGCTGCTCTGGGGCGA -> TCGGCTGCTCTGGGGCGAA
ATCGTATATTTATGTCAGC -> TCGTATATTTATGTCAGCG
ATCGTGCGCATTCTTGACC -> TCGTGCGCATTCTTGACCC
ATCGTGGAGCCAAGACTTG -> TCGTGGAGCCAAGACTTGG
ATCTCACTGGATACGCCAG -> TCTCACTGGATACGCCAGG
ATCTCAGCATAGGACTTGT -> TCTCAGCATAGGACTTGTA
ATCTCCGAAGGCACGCTTT -> TCTCCGAAGGCACGCTTTC
ATCTCGAACCTCCCATCTG -> TCTCGAACCTCCCATCTGT
ATCTGAACAATTAAGGTTC -> TCTGAACAATTAAGGTTCT
ATCTGAACACGGACTCCAT -> TCTGAACACGGACTCCATA
ATCTGAACAGCGTACAGAC -> TCTGAACAGCGTACAGACG
ATCTGAACATCGTGGAGCC -> TCTGAACATCGTGGAGCCA
ATCTGACGCTGCTGCCTAT -> TCTGACGCTGCTGCCTATT
ATCTGGATACGCCACAAGA -> TCTGGATACGCCACAAGAA
ATCTGGGGGGCCCCTCTCT -> TCTGGGGGGCCCCTCTCTC
ATCTGTACATCCCTATCGG -> TCTGTACATCCCTATCGGC
ATCTGTTTAACTTGATCTG -> TCTGTTTAACTTGATCTGA
ATCTTCGCGATCTTAGTGG -> TCTTCGCGATCTTAGTGGC
ATCTTGTGTTTGGGACCAC -> TCTTGTGTTTGGGACCACG
ATGAAAAGGCCCCAATCGA -> TGAAAAGGCCCCAATCGAA
ATGAAGAGTATATCCAGAG -> TGAAGAGTATATCCAGAGA
ATGACACCATAATCTTCGC -> TGACACCATAATCTTCGCG
ATGACCACGCTTACGCTTC -> TGACCACGCTTACGCTTCA
ATGATCAGCCTCATCTGGA -> TGATCAGCCTCATCTGGAT
ATGATTTCGGGGATCCATC -> TGATTTCGGGGATCCATCC
ATGCATACCCTAACGCAAG -> TGCATACCCTAACGCAAGC
ATGCATGGCGACTGATGTG -> TGCATGGCGACTGATGTGT
ATGCCTGGACTGGGTTCAA -> TGCCTGGACTGGGTTCAAG
ATGCGAACTCCACAACGCG -> TGCGAACTCCACAACGCGT
ATGCGATTTGCCTCCGTCT -> TGCGATTTGCCTCCGTCTG
ATGGAAACAAGAAGACTTT -> TGGAAACAAGAAGACTTTC
ATGGAGGCCAACATTGGAT -> TGGAGGCCAACATTGGATA
ATGGATTCGTAATGACACC -> TGGATTCGTAATGACACCA
ATGGCACTCGCCAGCAAAA -> TGGCACTCGCCAGCAAAAT
ATGGCGACTGATGTGTAAC -> TGGCGACTGATGTGTAACT
ATGGCGCCTACCCTTGGCA -> TGGCGCCTACCCTTGGCAG
ATGGGCGGTCATTACCAGT -> TGGGCGGTCATTACCAGTC
ATGTAAGTCATGGAGGCCA -> TGTAAGTCATGGAGGCCAA
ATGTACGCTGGGTTCACGC -> TGTACGCTGGGTTCACGCC
ATGTAGATTCCTTCTGTGC -> TGTAGATTCCTTCTGTGCA
ATGTCAATTCAGCCGGTTA -> TGTCAATTCAGCCGGTTAT
ATGTCACGGCCAAACTGTT -> TGTCACGGCCAAACTGTTA
ATGTCAGCGATATATCTTG -> TGTCAGCGATATATCTTGT
ATGTCGCACACAGGTGACG -> TGTCGCACACAGGTGACGT
ATGTGTAACTCTAGTGACT -> TGTGTAACTCTAGTGACTA
ATTAACCACTCTGATAGTG -> TTAACCACTCTGATAGTGT
ATTAAGGTTCTAGACTTGG -> TTAAGGTTCTAGACTTGGT
ATTAATGGAAACAAGAAGA -> TTAATGGAAACAAGAAGAC
ATTACAGATTGCGGTAAGT -> TTACAGATTGCGGTAAGTG
ATTACCAGTCCGCCTTAGC -> TTACCAGTCCGCCTTAGCG
ATTAGACGTAGATACAAGC -> TTAGACGTAGATACAAGCC
ATTAGCATAACTGAGAGGA -> TTAGCATAACTGAGAGGAC
ATTAGCCATGGCGCCTACC -> TTAGCCATGGCGCCTACCC
ATTCAGCCGGTTATAGCGC -> TTCAGCCGGTTATAGCGCC
ATTCCTTCTGTGCACACTC -> TTCCTTCTGTGCACACTCC
ATTCGCTAACCATAAACAG -> TTCGCTAACCATAAACAGT
ATTCGGAGTGGATAAATGT -> TTCGGAGTGGATAAATGTA
ATTCGTAATGACACCATAA -> TTCGTAATGACACCATAAT
ATTCTAAACAGGCGAGACG -> TTCTAAACAGGCGAGACGA
ATTCTTATGTACGCTGGGT -> TTCTTATGTACGCTGGGTT
ATTCTTGACCCCGCATAGT -> TTCTTGACCCCGCATAGTA
ATTGAACGTACAGAGGCGA -> TTGAACGTACAGAGGCGAA
ATTGACCCAACTAACAGGG -> TTGACCCAACTAACAGGGT
ATTGAGCGCTAAGGTCTAG -> TTGAGCGCTAAGGTCTAGG
ATTGAGGATTGGAGCACGT -> TTGAGGATTGGAGCACGTA
ATTGATTCTTATGTACGCT -> TTGATTCTTATGTACGCTG
ATTGCGGCATCGACGTTGG -> TTGCGGCATCGACGTTGGA
ATTGCGGGATGGCACTCGC -> TTGCGGGATGGCACTCGCC
ATTGCGGTAAGTGCTCGCC -> TTGCGGTAAGTGCTCGCCG
ATTGGAGCACGTATAACAG -> TTGGAGCACGTATAACAGC
ATTGGATAATCCTTCCCAG -> TTGGATAATCCTTCCCAGG
ATTGGGGAGACATACGGAC -> TTGGGGAGACATACGGACG
ATTTATGTCAGCGATATAT -> TTTATGTCAGCGATATATC
ATTTCGGGGATCCATCCTC -> TTTCGGGGATCCATCCTCC
ATTTGCCTCCGTCTGACCG -> TTTGCCTCCGTCTGACCGT
ATTTGGATTTTTGGGGGTA -> TTTGGATTTTTGGGGGTAC
ATTTGTTAATCGGCTGCTC -> TTTGTTAATCGGCTGCTCT
ATTTTAAGATCAGAATCAG -> TTTTAAGATCAGAATCAGA
ATTTTGCGAAAAGGCGATC -> TTTTGCGAAAAGGCGATCG
ATTTTGGCGGTATACGCTG -> TTTTGGCGGTATACGCTGC
ATTTTTGGGGGTACGGTCT -> TTTTTGGGGGTACGGTCTA
CAAAATACTACCTAAGGAT -> AAAATACTACCTAAGGATA
CAAAATCTCAGCATAGGAC -> AAAATCTCAGCATAGGACT
CAAACTGTTATCTGAACAA -> AAACTGTTATCTGAACAAT
CAAACTGTTATCTGAACAC -> AAACTGTTATCTGAACACG
CAAACTGTTATCTGAACAG -> AAACTGTTATCTGAACAGC
CAAACTGTTATCTGAACAT -> AAACTGTTATCTGAACATC
CAAAGACGATAAATAATTT -> AAAGACGATAAATAATTTT
CAAATCTCACTGGATACGC -> AAATCTCACTGGATACGCC
CAAATTGCGGCATCGACGT -> AAATTGCGGCATCGACGTT
CAACATTGAACGTACAGAG -> AACATTGAACGTACAGAGG
CAACATTGGATAATCCTTC -> AACATTGGATAATCCTTCC
CAACGCGTCCCCAAGTGTG -> AACGCGTCCCCAAGTGTGC
CAACTAACAGGGTTCCAAG -> AACTAACAGGGTTCCAAGA
CAAGAACAGGGTAGATCCT -> AAGAACAGGGTAGATCCTC
CAAGAACCGAAAAGAATCC -> AAGAACCGAAAAGAATCCA
CAAGAAGACTTTCGCTACC -> AAGAAGACTTTCGCTACCA
CAAGAATTAGCCATGGCGC -> AAGAATTAGCCATGGCGCC
CAAGACTTGGTGCATCGCT -> AAGACTTGGTGCATCGCTA
CAAGATGCATGGCGACTGA -> AAGATGCATGGCGACTGAT
CAAGCCTATGTCAATTCAG -> AAGCCTATGTCAATTCAGC
CAAGCTAACTTTCACGCGT -> AAGCTAACTTTCACGCGTT
CAAGGACATTCGGAGTGGA -> AAGGACATTCGGAGTGGAT
CAAGGCAAAATACTACCTA -> AAGGCAAAATACTACCTAA
CAAGGGATCTGGGGGGCCC -> AAGGGATCTGGGGGGCCCC
CAAGGTGTGCTCTCTGACA -> AAGGTGTGCTCTCTGACAT
CAAGTGTGCATATCAAGTT -> AAGTGTGCATATCAAGTTC
CAAGTTCCTGCGAAGGATT -> AAGTTCCTGCGAAGGATTC
CAATAACGGTCATGAAGAG -> AATAACGGTCATGAAGAGT
CAATACGATTTTGCGAAAA -> AATACGATTTTGCGAAAAG
CAATCGAAATAGCAATTTT -> AATCGAAATAGCAATTTTA
CAATGATCAGCCTCATCTG -> AATGATCAGCCTCATCTGG
CAATTAAGGTTCTAGACTT -> AATTAAGGTTCTAGACTTG
CAATTCAGCCGGTTATAGC -> AATTCAGCCGGTTATAGCG
CAATTTTAAGATCAGAATC -> AATTTTAAGATCAGAATCA
CACAAACTGTTATCTGAAC -> ACAAACTGTTATCTGAACA
CACAACGCGTCCCCAAGTG -> ACAACGCGTCCCCAAGTGT
CACAAGAACAGGGTAGATC -> ACAAGAACAGGGTAGATCC
CACAAGGACATTCGGAGTG -> ACAAGGACATTCGGAGTGG
CACAATGATCAGCCTCATC -> ACAATGATCAGCCTCATCT
CACACAGGTGACGTGGTCA -> ACACAGGTGACGTGGTCAA
CACACTCCGGTGATGAAAA -> ACACTCCGGTGATGAAAAG
CACAGGTGACGTGGTCAAG -> ACAGGTGACGTGGTCAAGA
CACATGATTTCGGGGATCC -> ACATGATTTCGGGGATCCA
CACATTACAGATTGCGGTA -> ACATTACAGATTGCGGTAA
CACCAATAACGGTCATGAA -> ACCAATAACGGTCATGAAG
CACCATAATCTTCGCGATC -> ACCATAATCTTCGCGATCT
CACCGAAAGGTGGATGTCG -> ACCGAAAGGTGGATGTCGC
CACCGAGATCAAGGGATCT -> ACCGAGATCAAGGGATCTG
CACCGGGTATATAGCTACC -> ACCGGGTATATAGCTACCT
CACCTAGGTTGATTGCGGG -> ACCTAGGTTGATTGCGGGA
CACGCCAATACGATTTTGC -> ACGCCAATACGATTTTGCG
CACGCCCTGCGACTCACCT -> ACGCCCTGCGACTCACCTA
CACGCGTTAATAGGTGATT -> ACGCGTTAATAGGTGATTT
CACGCTTACGCTTCACTTG -> ACGCTTACGCTTCACTTGC
CACGCTTTCTCCATCGGAG -> ACGCTTTCTCCATCGGAGG
CACGGACTCCATAAGACTT -> ACGGACTCCATAAGACTTG
CACGGCCAAACTGTTATCT -> ACGGCCAAACTGTTATCTG
CACGTAAGCCGTACCCTGG -> ACGTAAGCCGTACCCTGGA
CACGTATAACAGCGTTTAT -> ACGTATAACAGCGTTTATG
CACTCCAGACAGCGCGCTT -> ACTCCAGACAGCGCGCTTC
CACTCCGGTGATGAAAAGG -> ACTCCGGTGATGAAAAGGC
CACTCGCCAGCAAAATCTC -> ACTCGCCAGCAAAATCTCA
CACTCGGGACTCGTAGCGA -> ACTCGGGACTCGTAGCGAG
CACTCTGATAGTGTACTAT -> ACTCTGATAGTGTACTATT
CACTGGATACGCCAGGAAG -> ACTGGATACGCCAGGAAGC
CACTGGTCACCAATAACGG -> ACTGGTCACCAATAACGGT
CACTTATACTTAGCACTCC -> ACTTATACTTAGCACTCCA
CACTTGCGACACCGGGTAT -> ACTTGCGACACCGGGTATA
CAGAATCAGAGCAACATTG -> AGAATCAGAGCAACATTGA
CAGACAGCGCGCTTCCGTT -> AGACAGCGCGCTTCCGTTT
CAGACGAGACTTGGTGCAT -> AGACGAGACTTGGTGCATC
CAGACTCGTGTAGGAGTCC -> AGACTCGTGTAGGAGTCCT
CAGAGACGCACTTATACTT -> AGAGACGCACTTATACTTA
CAGAGCAACATTGAACGTA -> AGAGCAACATTGAACGTAC
CAGAGGCGAAGATGTCACG -> AGAGGCGAAGATGTCACGG
CAGATCGGACTTCCCTAGA -> AGATCGGACTTCCCTAGAT
CAGATCGGCGGACGCTGAC -> AGATCGGCGGACGCTGACA
CAGATTGCGGTAAGTGCTC -> AGATTGCGGTAAGTGCTCG
CAGCAAAATCTCAGCATAG -> AGCAAAATCTCAGCATAGG
CAGCACATGATTTCGGGGA -> AGCACATGATTTCGGGGAT
CAGCATAGGACTTGTAGTG -> AGCATAGGACTTGTAGTGT
CAGCCGGTTATAGCGCCAT -> AGCCGGTTATAGCGCCATA
CAGCCTCATCTGGATACGC -> AGCCTCATCTGGATACGCC
CAGCGAGTAAGCGCAGCTT -> AGCGAGTAAGCGCAGCTTT
CAGCGATATATCTTGTGTT -> AGCGATATATCTTGTGTTT
CAGCGCGCTTCCGTTTCAG -> AGCGCGCTTCCGTTTCAGT
CAGCGTACAGACGAGACTT -> AGCGTACAGACGAGACTTG
CAGCGTTTATGGGCGGTCA -> AGCGTTTATGGGCGGTCAT
CAGCTTTTACCTTGCGGTG -> AGCTTTTACCTTGCGGTGG
CAGGAAGCTGTTGTCGTAC -> AGGAAGCTGTTGTCGTACT
CAGGAGGCATCTGTACATC -> AGGAGGCATCTGTACATCC
CAGGAGTCAGGCTAAGTCT -> AGGAGTCAGGCTAAGTCTT
CAGGCGAGACGACCAGGTT -> AGGCGAGACGACCAGGTTC
CAGGCTAAGTCTTTGTAGA -> AGGCTAAGTCTTTGTAGAG
CAGGGCCACTCGGGACTCG -> AGGGCCACTCGGGACTCGT
CAGGGTAGATCCTCGTAGG -> AGGGTAGATCCTCGTAGGG
CAGGGTTCCAAGAATTAGC -> AGGGTTCCAAGAATTAGCC
CAGGTGACGTGGTCAAGAA -> AGGTGACGTGGTCAAGAAC
CAGGTTCCACAAACTGTTA -> AGGTTCCACAAACTGTTAT
CAGTATTGACCCAACTAAC -> AGTATTGACCCAACTAACA
CAGTCACATTACAGATTGC -> AGTCACATTACAGATTGCG
CAGTCCCAGGGCCACTCGG -> AGTCCCAGGGCCACTCGGG
CAGTCCGCCTTAGCGATGC -> AGTCCGCCTTAGCGATGCC
CAGTTACGCTGACCTATAT -> AGTTACGCTGACCTATATG
CATAAACAGTCCCAGGGCC -> ATAAACAGTCCCAGGGCCA
CATAACTGAGAGGACCTTC -> ATAACTGAGAGGACCTTCG
CATAAGACTTGGTGCATCG -> ATAAGACTTGGTGCATCGC
CATAATCTTCGCGATCTTA -> ATAATCTTCGCGATCTTAG
CATACCCTAACGCAAGCTA -> ATACCCTAACGCAAGCTAA
CATACGGACGTCGTGCGAT -> ATACGGACGTCGTGCGATG
CATAGGACTTGTAGTGTGA -> ATAGGACTTGTAGTGTGAG
CATAGTAAGACCCAAATCT -> ATAGTAAGACCCAAATCTC
CATATCAAGTTCCTGCGAA -> ATATCAAGTTCCTGCGAAG
CATATTAGCATAACTGAGA -> ATATTAGCATAACTGAGAG
CATCCCCCAGCGAGTAAGC -> ATCCCCCAGCGAGTAAGCG
CATCCCTATCGGCAGATCG -> ATCCCTATCGGCAGATCGG
CATCCTCCGTTATAGTAAG -> ATCCTCCGTTATAGTAAGT
CATCGACGTTGGACATCCC -> ATCGACGTTGGACATCCCC
CATCGCTAAACGTTGAGTC -> ATCGCTAAACGTTGAGTCG
CATCGCTAAACTGGGAGCG -> ATCGCTAAACTGGGAGCGG
CATCGCTAAGCGGAGTTCC -> ATCGCTAAGCGGAGTTCCC
CATCGCTAATAAGTGTTCA -> ATCGCTAATAAGTGTTCAG
CATCGGAGGACTGGCTTGC -> ATCGGAGGACTGGCTTGCG
CATCGTGCGCATTCTTGAC -> ATCGTGCGCATTCTTGACC
CATCGTGGAGCCAAGACTT -> ATCGTGGAGCCAAGACTTG
CATCTGGATACGCCACAAG -> ATCTGGATACGCCACAAGA
CATCTGTACATCCCTATCG -> ATCTGTACATCCCTATCGG
CATCTGTTTAACTTGATCT -> ATCTGTTTAACTTGATCTG
CATGAAGAGTATATCCAGA -> ATGAAGAGTATATCCAGAG
CATGATTTCGGGGATCCAT -> ATGATTTCGGGGATCCATC
CATGCGAACTCCACAACGC -> ATGCGAACTCCACAACGCG
CATGGAGGCCAACATTGGA -> ATGGAGGCCAACATTGGAT
CATGGCGACTGATGTGTAA -> ATGGCGACTGATGTGTAAC
CATGGCGCCTACCCTTGGC -> ATGGCGCCTACCCTTGGCA
CATGTAAGTCATGGAGGCC -> ATGTAAGTCATGGAGGCCA
CATTACAGATTGCGGTAAG -> ATTACAGATTGCGGTAAGT
CATTACCAGTCCGCCTTAG -> ATTACCAGTCCGCCTTAGC
CATTCGGAGTGGATAAATG -> ATTCGGAGTGGATAAATGT
CATTCTTGACCCCGCATAG -> ATTCTTGACCCCGCATAGT
CATTGAACGTACAGAGGCG -> ATTGAACGTACAGAGGCGA
CATTGGATAATCCTTCCCA -> ATTGGATAATCCTTCCCAG
CATTGGGGAGACATACGGA -> ATTGGGGAGACATACGGAC
CCAAACTGTTATCTGAACA -> CAAACTGTTATCTGAACAC
CCAAATCTCACTGGATACG -> CAAATCTCACTGGATACGC
CCAACATTGGATAATCCTT -> CAACATTGGATAATCCTTC
CCAACTAACAGGGTTCCAA -> CAACTAACAGGGTTCCAAG
CCAAGAATTAGCCATGGCG -> CAAGAATTAGCCATGGCGC
CCAAGACTTGGTGCATCGC -> CAAGACTTGGTGCATCGCT
CCAAGATGCATGGCGACTG -> CAAGATGCATGGCGACTGA
CCAAGGCAAAATACTACCT -> CAAGGCAAAATACTACCTA
CCAAGTGTGCATATCAAGT -> CAAGTGTGCATATCAAGTT
CCAATAACGGTCATGAAGA -> CAATAACGGTCATGAAGAG
CCAATACGATTTTGCGAAA -> CAATACGATTTTGCGAAAA
CCAATCGAAATAGCAATTT -> CAATCGAAATAGCAATTTT
CCACAAACTGTTATCTGAA -> CACAAACTGTTATCTGAAC
CCACAACGCGTCCCCAAGT -> CACAACGCGTCCCCAAGTG
CCACAAGAACAGGGTAGAT -> CACAAGAACAGGGTAGATC
CCACGCTTACGCTTCACTT -> CACGCTTACGCTTCACTTG
CCACGTAAGCCGTACCCTG -> CACGTAAGCCGTACCCTGG
CCACTCGGGACTCGTAGCG -> CACTCGGGACTCGTAGCGA
CCACTCTGATAGTGTACTA -> CACTCTGATAGTGTACTAT
CCAGACAGCGCGCTTCCGT -> CAGACAGCGCGCTTCCGTT
CCAGAGACGCACTTATACT -> CAGAGACGCACTTATACTT
CCAGCAAAATCTCAGCATA -> CAGCAAAATCTCAGCATAG
CCAGCGAGTAAGCGCAGCT -> CAGCGAGTAAGCGCAGCTT
CCAGGAAGCTGTTGTCGTA -> CAGGAAGCTGTTGTCGTAC
CCAGGAGTCAGGCTAAGTC -> CAGGAGTCAGGCTAAGTCT
CCAGGGCCACTCGGGACTC -> CAGGGCCACTCGGGACTCG
CCAGGTTCCACAAACTGTT -> CAGGTTCCACAAACTGTTA
CCAGTCCGCCTTAGCGATG -> CAGTCCGCCTTAGCGATGC
CCAGTTACGCTGACCTATA -> CAGTTACGCTGACCTATAT
CCATAAACAGTCCCAGGGC -> CATAAACAGTCCCAGGGCC
CCATAAGACTTGGTGCATC -> CATAAGACTTGGTGCATCG
CCATAATCTTCGCGATCTT -> CATAATCTTCGCGATCTTA
CCATATTAGCATAACTGAG -> CATATTAGCATAACTGAGA
CCATCCTCCGTTATAGTAA -> CATCCTCCGTTATAGTAAG
CCATCGGAGGACTGGCTTG -> CATCGGAGGACTGGCTTGC
CCATCGTGCGCATTCTTGA -> CATCGTGCGCATTCTTGAC
CCATCTGTTTAACTTGATC -> CATCTGTTTAACTTGATCT
CCATGGCGCCTACCCTTGG -> CATGGCGCCTACCCTTGGC
CCCAAATCTCACTGGATAC -> CCAAATCTCACTGGATACG
CCCAACTAACAGGGTTCCA -> CCAACTAACAGGGTTCCAA
CCCAAGTGTGCATATCAAG -> CCAAGTGTGCATATCAAGT
CCCAATCGAAATAGCAATT -> CCAATCGAAATAGCAATTT
CCCAGCGAGTAAGCGCAGC -> CCAGCGAGTAAGCGCAGCT
CCCAGGAGTCAGGCTAAGT -> CCAGGAGTCAGGCTAAGTC
CCCAGGGCCACTCGGGACT -> CCAGGGCCACTCGGGACTC
CCCATCTGTTTAACTTGAT -> CCATCTGTTTAACTTGATC
CCCCAAGTGTGCATATCAA -> CCCAAGTGTGCATATCAAG
CCCCAATCGAAATAGCAAT -> CCCAATCGAAATAGCAATT
CCCCAGCGAGTAAGCGCAG -> CCCAGCGAGTAAGCGCAGC
CCCCCAGCGAGTAAGCGCA -> CCCCAGCGAGTAAGCGCAG
CCCCGCATAGTAAGACCCA -> CCCGCATAGTAAGACCCAA
CCCCTCTCTCTGGGAATCA -> CCCTCTCTCTGGGAATCAG
CCCCTTGGCCTTTAACGGA -> CCCTTGGCCTTTAACGGAG
CCCGAGTAAAAGATGACCA -> CCGAGTAAAAGATGACCAC
CCCGCATAGTAAGACCCAA -> CCGCATAGTAAGACCCAAA
CCCGGGTTTCTCGTGGACT -> CCGGGTTTCTCGTGGACTA
CCCTAACGCAAGCTAACTT -> CCTAACGCAAGCTAACTTT
CCCTAGATCATGCGAACTC -> CCTAGATCATGCGAACTCC
CCCTATCGGCAGATCGGAC -> CCTATCGGCAGATCGGACT
CCCTCTCTCTGGGAATCAG -> CCTCTCTCTGGGAATCAGC
CCCTGCGACTCACCTAGGT -> CCTGCGACTCACCTAGGTT
CCCTGGACCAAGGCAAAAT -> CCTGGACCAAGGCAAAATA
CCCTTGGCAGACTCGTGTA -> CCTTGGCAGACTCGTGTAG
CCCTTGGCCTTTAACGGAG -> CCTTGGCCTTTAACGGAGC
CCGAAAAGAATCCAAGATG -> CGAAAAGAATCCAAGATGC
CCGAAAGGTGGATGTCGCA -> CGAAAGGTGGATGTCGCAC
CCGAAGGCACGCTTTCTCC -> CGAAGGCACGCTTTCTCCA
CCGAGATCAAGGGATCTGG -> CGAGATCAAGGGATCTGGG
CCGAGTAAAAGATGACCAC -> CGAGTAAAAGATGACCACG
CCGCACGCCCTGCGACTCA -> CGCACGCCCTGCGACTCAC
CCGCATAGTAAGACCCAAA -> CGCATAGTAAGACCCAAAT
CCGCCTTAGCGATGCCTGG -> CGCCTTAGCGATGCCTGGA
CCGCCTTTCCCGAGTAAAA -> CGCCTTTCCCGAGTAAAAG
CCGGGTATATAGCTACCTC -> CGGGTATATAGCTACCTCA
CCGGGTTTCTCGTGGACTA -> CGGGTTTCTCGTGGACTAT
CCGGTGATGAAAAGGCCCC -> CGGTGATGAAAAGGCCCCA
CCGGTTATAGCGCCATATT -> CGGTTATAGCGCCATATTA
CCGTAAAAAAGTCACAAGG -> CGTAAAAAAGTCACAAGGA
CCGTACCCTGGACCAAGGC -> CGTACCCTGGACCAAGGCA
CCGTCGAGACACTGGTCAC -> CGTCGAGACACTGGTCACC
CCGTCTGACCGTCGAGACA -> CGTCTGACCGTCGAGACAC
CCGTTATAGTAAGTCGGTC -> CGTTATAGTAAGTCGGTCT
CCGTTTCAGTATTGACCCA -> CGTTTCAGTATTGACCCAA
CCTAACGCAAGCTAACTTT -> CTAACGCAAGCTAACTTTC
CCTAAGGATAGGGGGTAAT -> CTAAGGATAGGGGGTAATT
CCTACCCTTGGCAGACTCG -> CTACCCTTGGCAGACTCGT
CCTAGATCATGCGAACTCC -> CTAGATCATGCGAACTCCA
CCTAGGTTGATTGCGGGAT -> CTAGGTTGATTGCGGGATG
CCTATATGCGATTTGCCTC -> CTATATGCGATTTGCCTCC
CCTATCGGCAGATCGGACT -> CTATCGGCAGATCGGACTT
CCTATGTCAATTCAGCCGG -> CTATGTCAATTCAGCCGGT
CCTATTAATGGAAACAAGA -> CTATTAATGGAAACAAGAA
CCTCAAAGACGATAAATAA -> CTCAAAGACGATAAATAAT
CCTCAAATTGCGGCATCGA -> CTCAAATTGCGGCATCGAC
CCTCATCTGGATACGCCAC -> CTCATCTGGATACGCCACA
CCTCCCATCTGTTTAACTT -> CTCCCATCTGTTTAACTTG
CCTCCGTCTGACCGTCGAG -> CTCCGTCTGACCGTCGAGA
CCTCCGTTATAGTAAGTCG -> CTCCGTTATAGTAAGTCGG
CCTCGTAGGGGGGTGTACG -> CTCGTAGGGGGGTGTACGT
CCTCTCTCTGGGAATCAGC -> CTCTCTCTGGGAATCAGCA
CCTGCGAAGGATTCTAAAC -> CTGCGAAGGATTCTAAACA
CCTGCGACTCACCTAGGTT -> CTGCGACTCACCTAGGTTG
CCTGGACCAAGGCAAAATA -> CTGGACCAAGGCAAAATAC
CCTGGACTGGGTTCAAGGT -> CTGGACTGGGTTCAAGGTG
CCTTAACGGTAGTCCTTCG -> CTTAACGGTAGTCCTTCGT
CCTTAGCGATGCCTGGACT -> CTTAGCGATGCCTGGACTG
CCTTCCCAGGAGTCAGGCT -> CTTCCCAGGAGTCAGGCTA
CCTTCGCTTCTTCTGATAT -> CTTCGCTTCTTCTGATATT
CCTTCGTTCAAACTGTTAT -> CTTCGTTCAAACTGTTATC
CCTTCTGTGCACACTCCGG -> CTTCTGTGCACACTCCGGT
CCTTGCGGTGGGTTAGTAA -> CTTGCGGTGGGTTAGTAAT
CCTTGGCAGACTCGTGTAG -> CTTGGCAGACTCGTGTAGG
CCTTGGCCTTTAACGGAGC -> CTTGGCCTTTAACGGAGCC
CCTTTAACGGAGCCTTAAC -> CTTTAACGGAGCCTTAACG
CCTTTCCCGAGTAAAAGAT -> CTTTCCCGAGTAAAAGATG
CGAAAAGAATCCAAGATGC -> GAAAAGAATCCAAGATGCA
CGAAAAGGCGATCGTATAT -> GAAAAGGCGATCGTATATT
CGAAAGGTGGATGTCGCAC -> GAAAGGTGGATGTCGCACA
CGAAATAGCAATTTTAAGA -> GAAATAGCAATTTTAAGAT
CGAACCTCCCATCTGTTTA -> GAACCTCCCATCTGTTTAA
CGAACTCCACAACGCGTCC -> GAACTCCACAACGCGTCCC
CGAAGAATCTCCGAAGGCA -> GAAGAATCTCCGAAGGCAC
CGAAGATGTCACGGCCAAA -> GAAGATGTCACGGCCAAAC
CGAAGGATTCTAAACAGGC -> GAAGGATTCTAAACAGGCG
CGAAGGCACGCTTTCTCCA -> GAAGGCACGCTTTCTCCAT
CGAATCCAGTTACGCTGAC -> GAATCCAGTTACGCTGACC
CGACACCGGGTATATAGCT -> GACACCGGGTATATAGCTA
CGACCAGGTTCCACAAACT -> GACCAGGTTCCACAAACTG
CGACGTTGGACATCCCCCA -> GACGTTGGACATCCCCCAG
CGACTCACCTAGGTTGATT -> GACTCACCTAGGTTGATTG
CGACTGATGTGTAACTCTA -> GACTGATGTGTAACTCTAG
CGAGACACTGGTCACCAAT -> GAGACACTGGTCACCAATA
CGAGACGACCAGGTTCCAC -> GAGACGACCAGGTTCCACA
CGAGACTTGGTGCATCGCT -> GAGACTTGGTGCATCGCTA
CGAGATCAAGGGATCTGGG -> GAGATCAAGGGATCTGGGG
CGAGCGGATTAGACGTAGA -> GAGCGGATTAGACGTAGAT
CGAGTAAAAGATGACCACG -> GAGTAAAAGATGACCACGC
CGAGTAAGCGCAGCTTTTA -> GAGTAAGCGCAGCTTTTAC
CGATAAATAATTTTGGCGG -> GATAAATAATTTTGGCGGT
CGATATATCTTGTGTTTGG -> GATATATCTTGTGTTTGGG
CGATCGTATATTTATGTCA -> GATCGTATATTTATGTCAG
CGATCTCGAACCTCCCATC -> GATCTCGAACCTCCCATCT
CGATGCATACCCTAACGCA -> GATGCATACCCTAACGCAA
CGATGCCTGGACTGGGTTC -> GATGCCTGGACTGGGTTCA
CGATTTGCCTCCGTCTGAC -> GATTTGCCTCCGTCTGACC
CGATTTTGCGAAAAGGCGA -> GATTTTGCGAAAAGGCGAT
CGCAAGCTAACTTTCACGC -> GCAAGCTAACTTTCACGCG
CGCACACAGGTGACGTGGT -> GCACACAGGTGACGTGGTC
CGCACCGAAAGGTGGATGT -> GCACCGAAAGGTGGATGTC
CGCACGCCCTGCGACTCAC -> GCACGCCCTGCGACTCACC
CGCACTTATACTTAGCACT -> GCACTTATACTTAGCACTC
CGCAGCTTTTACCTTGCGG -> GCAGCTTTTACCTTGCGGT
CGCATAGTAAGACCCAAAT -> GCATAGTAAGACCCAAATC
CGCATTCTTGACCCCGCAT -> GCATTCTTGACCCCGCATA
CGCCAATACGATTTTGCGA -> GCCAATACGATTTTGCGAA
CGCCACAAGAACAGGGTAG -> GCCACAAGAACAGGGTAGA
CGCCAGCAAAATCTCAGCA -> GCCAGCAAAATCTCAGCAT
CGCCAGGAAGCTGTTGTCG -> GCCAGGAAGCTGTTGTCGT
CGCCATATTAGCATAACTG -> GCCATATTAGCATAACTGA
CGCCCTGCGACTCACCTAG -> GCCCTGCGACTCACCTAGG
CGCCGCACGCCCTGCGACT -> GCCGCACGCCCTGCGACTC
CGCCTACCCTTGGCAGACT -> GCCTACCCTTGGCAGACTC
CGCCTTAGCGATGCCTGGA -> GCCTTAGCGATGCCTGGAC
CGCCTTTCCCGAGTAAAAG -> GCCTTTCCCGAGTAAAAGA
CGCGATCTTAGTGGCAGCA -> GCGATCTTAGTGGCAGCAT
CGCGCTTCCGTTTCAGTAT -> GCGCTTCCGTTTCAGTATT
CGCGTCCCCAAGTGTGCAT -> GCGTCCCCAAGTGTGCATA
CGCGTTAATAGGTGATTTG -> GCGTTAATAGGTGATTTGT
CGCTAAACGTTGAGTCGCT -> GCTAAACGTTGAGTCGCTT
CGCTAAACTGGGAGCGGCA -> GCTAAACTGGGAGCGGCAG
CGCTAACCATAAACAGTCC -> GCTAACCATAAACAGTCCC
CGCTAAGCGGAGTTCCCGG -> GCTAAGCGGAGTTCCCGGG
CGCTAAGGTCTAGGCCGCC -> GCTAAGGTCTAGGCCGCCT
CGCTAATAAGTGTTCAGGA -> GCTAATAAGTGTTCAGGAG
CGCTACCATCGTGCGCATT -> GCTACCATCGTGCGCATTC
CGCTGACACAATGATCAGC -> GCTGACACAATGATCAGCC
CGCTGACCTATATGCGATT -> GCTGACCTATATGCGATTT
CGCTGCCGTAAAAAAGTCA -> GCTGCCGTAAAAAAGTCAC
CGCTGCTGCCTATTAATGG -> GCTGCTGCCTATTAATGGA
CGCTGGGTTCACGCCAATA -> GCTGGGTTCACGCCAATAC
CGCTTACGCTTCACTTGCG -> GCTTACGCTTCACTTGCGA
CGCTTATTGATTCTTATGT -> GCTTATTGATTCTTATGTA
CGCTTCACTTGCGACACCG -> GCTTCACTTGCGACACCGG
CGCTTCCGTTTCAGTATTG -> GCTTCCGTTTCAGTATTGA
CGCTTCTTCTGATATTGAG -> GCTTCTTCTGATATTGAGG
CGCTTTCTCCATCGGAGGA -> GCTTTCTCCATCGGAGGAC
CGGACGCTGACACAATGAT -> GGACGCTGACACAATGATC
CGGACGTCGTGCGATGCAT -> GGACGTCGTGCGATGCATA
CGGACTCCATAAGACTTGG -> GGACTCCATAAGACTTGGT
CGGACTTCCCTAGATCATG -> GGACTTCCCTAGATCATGC
CGGAGCCTTAACGGTAGTC -> GGAGCCTTAACGGTAGTCC
CGGAGGACTGGCTTGCGGC -> GGAGGACTGGCTTGCGGCA
CGGAGTGGATAAATGTAGA -> GGAGTGGATAAATGTAGAT
CGGAGTTCCCGGGTTTCTC -> GGAGTTCCCGGGTTTCTCG
CGGATTAGACGTAGATACA -> GGATTAGACGTAGATACAA
CGGCAAACTGTTATCTGAA -> GGCAAACTGTTATCTGAAC
CGGCAGATCGGACTTCCCT -> GGCAGATCGGACTTCCCTA
CGGCAGATCGGCGGACGCT -> GGCAGATCGGCGGACGCTG
CGGCATCGACGTTGGACAT -> GGCATCGACGTTGGACATC
CGGCCAAACTGTTATCTGA -> GGCCAAACTGTTATCTGAA
CGGCGGACGCTGACACAAT -> GGCGGACGCTGACACAATG
CGGCTGCTCTGGGGCGAAG -> GGCTGCTCTGGGGCGAAGA
CGGGACTCGTAGCGAGCGG -> GGGACTCGTAGCGAGCGGA
CGGGATGGCACTCGCCAGC -> GGGATGGCACTCGCCAGCA
CGGGGATCCATCCTCCGTT -> GGGGATCCATCCTCCGTTA
CGGGTATATAGCTACCTCA -> GGGTATATAGCTACCTCAA
CGGGTTTCTCGTGGACTAT -> GGGTTTCTCGTGGACTATT
CGGTAAGTGCTCGCCGCAC -> GGTAAGTGCTCGCCGCACG
CGGTAGTCCTTCGTTCAAA -> GGTAGTCCTTCGTTCAAAC
CGGTATACGCTGCCGTAAA -> GGTATACGCTGCCGTAAAA
CGGTCATGAAGAGTATATC -> GGTCATGAAGAGTATATCC
CGGTCATTACCAGTCCGCC -> GGTCATTACCAGTCCGCCT
CGGTCTATCGCACCGAAAG -> GGTCTATCGCACCGAAAGG
CGGTCTATTGAGCGCTAAG -> GGTCTATTGAGCGCTAAGG
CGGTGATGAAAAGGCCCCA -> GGTGATGAAAAGGCCCCAA
CGGTGGGTTAGTAATCAGT -> GGTGGGTTAGTAATCAGTC
CGGTTATAGCGCCATATTA -> GGTTATAGCGCCATATTAG
CGTAAAAAAGTCACAAGGA -> GTAAAAAAGTCACAAGGAC
CGTAAGCCGTACCCTGGAC -> GTAAGCCGTACCCTGGACC
CGTAATGACACCATAATCT -> GTAATGACACCATAATCTT
CGTACAGACGAGACTTGGT -> GTACAGACGAGACTTGGTG
CGTACAGAGGCGAAGATGT -> GTACAGAGGCGAAGATGTC
CGTACCCTGGACCAAGGCA -> GTACCCTGGACCAAGGCAA
CGTACTATCATTGGGGAGA -> GTACTATCATTGGGGAGAC
CGTAGATACAAGCCTATGT -> GTAGATACAAGCCTATGTC
CGTAGCGAGCGGATTAGAC -> GTAGCGAGCGGATTAGACG
CGTAGGGGGGTGTACGTCA -> GTAGGGGGGTGTACGTCAC
CGTATAACAGCGTTTATGG -> GTATAACAGCGTTTATGGG
CGTATATTTATGTCAGCGA -> GTATATTTATGTCAGCGAT
CGTCACCGAGATCAAGGGA -> GTCACCGAGATCAAGGGAT
CGTCCCCAAGTGTGCATAT -> GTCCCCAAGTGTGCATATC
CGTCGAGACACTGGTCACC -> GTCGAGACACTGGTCACCA
CGTCGTGCGATGCATACCC -> GTCGTGCGATGCATACCCT
CGTCTGACCGTCGAGACAC -> GTCTGACCGTCGAGACACT
CGTGCGATGCATACCCTAA -> GTGCGATGCATACCCTAAC
CGTGCGCATTCTTGACCCC -> GTGCGCATTCTTGACCCCG
CGTGGACTATTCGCTAACC -> GTGGACTATTCGCTAACCA
CGTGGAGCCAAGACTTGGT -> GTGGAGCCAAGACTTGGTG
CGTGGTCAAGAACCGAAAA -> GTGGTCAAGAACCGAAAAG
CGTGTAGGAGTCCTCAAAT -> GTGTAGGAGTCCTCAAATT
CGTTAATAGGTGATTTGTT -> GTTAATAGGTGATTTGTTA
CGTTATAGTAAGTCGGTCT -> GTTATAGTAAGTCGGTCTA
CGTTCAAACTGTTATCTGA -> GTTCAAACTGTTATCTGAA
CGTTGAGTCGCTTATTGAT -> GTTGAGTCGCTTATTGATT
CGTTGGACATCCCCCAGCG -> GTTGGACATCCCCCAGCGA
CGTTTATGGGCGGTCATTA -> GTTTATGGGCGGTCATTAC
CGTTTCAGTATTGACCCAA -> GTTTCAGTATTGACCCAAC
CTAAACAGGCGAGACGACC -> TAAACAGGCGAGACGACCA
CTAAACGTTGAGTCGCTTA -> TAAACGTTGAGTCGCTTAT
CTAAACTGGGAGCGGCAGA -> TAAACTGGGAGCGGCAGAT
CTAACAGGGTTCCAAGAAT -> TAACAGGGTTCCAAGAATT
CTAACCATAAACAGTCCCA -> TAACCATAAACAGTCCCAG
CTAACGCAAGCTAACTTTC -> TAACGCAAGCTAACTTTCA
CTAACTTTCACGCGTTAAT -> TAACTTTCACGCGTTAATA
CTAAGCGGAGTTCCCGGGT -> TAAGCGGAGTTCCCGGGTT
CTAAGGATAGGGGGTAATT -> TAAGGATAGGGGGTAATTA
CTAAGGTCTAGGCCGCCTT -> TAAGGTCTAGGCCGCCTTT
CTAAGTCTTTGTAGAGGGA -> TAAGTCTTTGTAGAGGGAC
CTAATAAGTGTTCAGGAGG -> TAATAAGTGTTCAGGAGGC
CTACCATCGTGCGCATTCT -> TACCATCGTGCGCATTCTT
CTACCCTTGGCAGACTCGT -> TACCCTTGGCAGACTCGTG
CTACCTAAGGATAGGGGGT -> TACCTAAGGATAGGGGGTA
CTACCTCAAAGACGATAAA -> TACCTCAAAGACGATAAAT
CTAGACTTGGTGCATCGCT -> TAGACTTGGTGCATCGCTA
CTAGATCATGCGAACTCCA -> TAGATCATGCGAACTCCAC
CTAGGCCGCCTTTCCCGAG -> TAGGCCGCCTTTCCCGAGT
CTAGGTTGATTGCGGGATG -> TAGGTTGATTGCGGGATGG
CTAGTGACTATGGATTCGT -> TAGTGACTATGGATTCGTA
CTATATGCGATTTGCCTCC -> TATATGCGATTTGCCTCCG
CTATCATTGGGGAGACATA -> TATCATTGGGGAGACATAC
CTATCGCACCGAAAGGTGG -> TATCGCACCGAAAGGTGGA
CTATCGGCAGATCGGACTT -> TATCGGCAGATCGGACTTC
CTATGGATTCGTAATGACA -> TATGGATTCGTAATGACAC
CTATGTCAATTCAGCCGGT -> TATGTCAATTCAGCCGGTT
CTATTAATGGAAACAAGAA -> TATTAATGGAAACAAGAAG
CTATTCGCTAACCATAAAC -> TATTCGCTAACCATAAACA
CTATTGAGCGCTAAGGTCT -> TATTGAGCGCTAAGGTCTA
CTATTTGGATTTTTGGGGG -> TATTTGGATTTTTGGGGGT
CTCAAAGACGATAAATAAT -> TCAAAGACGATAAATAATT
CTCAAATTGCGGCATCGAC -> TCAAATTGCGGCATCGACG
CTCACCTAGGTTGATTGCG -> TCACCTAGGTTGATTGCGG
CTCACTGGATACGCCAGGA -> TCACTGGATACGCCAGGAA
CTCAGCATAGGACTTGTAG -> TCAGCATAGGACTTGTAGT
CTCATCTGGATACGCCACA -> TCATCTGGATACGCCACAA
CTCCACAACGCGTCCCCAA -> TCCACAACGCGTCCCCAAG
CTCCAGACAGCGCGCTTCC -> TCCAGACAGCGCGCTTCCG
CTCCATAAGACTTGGTGCA -> TCCATAAGACTTGGTGCAT
CTCCATCGGAGGACTGGCT -> TCCATCGGAGGACTGGCTT
CTCCCATCTGTTTAACTTG -> TCCCATCTGTTTAACTTGA
CTCCGAAGGCACGCTTTCT -> TCCGAAGGCACGCTTTCTC
CTCCGGTGATGAAAAGGCC -> TCCGGTGATGAAAAGGCCC
CTCCGTCTGACCGTCGAGA -> TCCGTCTGACCGTCGAGAC
CTCCGTTATAGTAAGTCGG -> TCCGTTATAGTAAGTCGGT
CTCGAACCTCCCATCTGTT -> TCGAACCTCCCATCTGTTT
CTCGCCAGCAAAATCTCAG -> TCGCCAGCAAAATCTCAGC
CTCGCCGCACGCCCTGCGA -> TCGCCGCACGCCCTGCGAC
CTCGGGACTCGTAGCGAGC -> TCGGGACTCGTAGCGAGCG
CTCGTAGCGAGCGGATTAG -> TCGTAGCGAGCGGATTAGA
CTCGTAGGGGGGTGTACGT -> TCGTAGGGGGGTGTACGTC
CTCGTGGACTATTCGCTAA -> TCGTGGACTATTCGCTAAC
CTCGTGTAGGAGTCCTCAA -> TCGTGTAGGAGTCCTCAAA
CTCTAGTGACTATGGATTC -> TCTAGTGACTATGGATTCG
CTCTCTCTGGGAATCAGCA -> TCTCTCTGGGAATCAGCAC
CTCTCTGACATGTAAGTCA -> TCTCTGACATGTAAGTCAT
CTCTCTGGGAATCAGCACA -> TCTCTGGGAATCAGCACAT
CTCTGACATGTAAGTCATG -> TCTGACATGTAAGTCATGG
CTCTGATAGTGTACTATTT -> TCTGATAGTGTACTATTTG
CTCTGGGAATCAGCACATG -> TCTGGGAATCAGCACATGA
CTCTGGGGCGAAGAATCTC -> TCTGGGGCGAAGAATCTCC
CTGAACAATTAAGGTTCTA -> TGAACAATTAAGGTTCTAG
CTGAACACGGACTCCATAA -> TGAACACGGACTCCATAAG
CTGAACAGCGTACAGACGA -> TGAACAGCGTACAGACGAG
CTGAACATCGTGGAGCCAA -> TGAACATCGTGGAGCCAAG
CTGACACAATGATCAGCCT -> TGACACAATGATCAGCCTC
CTGACATGTAAGTCATGGA -> TGACATGTAAGTCATGGAG
CTGACCGTCGAGACACTGG -> TGACCGTCGAGACACTGGT
CTGACCTATATGCGATTTG -> TGACCTATATGCGATTTGC
CTGACGCTGCTGCCTATTA -> TGACGCTGCTGCCTATTAA
CTGAGAGGACCTTCGCTTC -> TGAGAGGACCTTCGCTTCT
CTGATAGTGTACTATTTGG -> TGATAGTGTACTATTTGGA
CTGATATTGAGGATTGGAG -> TGATATTGAGGATTGGAGC
CTGATGTGTAACTCTAGTG -> TGATGTGTAACTCTAGTGA
CTGCCGTAAAAAAGTCACA -> TGCCGTAAAAAAGTCACAA
CTGCCTATTAATGGAAACA -> TGCCTATTAATGGAAACAA
CTGCGAAGGATTCTAAACA -> TGCGAAGGATTCTAAACAG
CTGCGACTCACCTAGGTTG -> TGCGACTCACCTAGGTTGA
CTGCTCTGGGGCGAAGAAT -> TGCTCTGGGGCGAAGAATC
CTGCTGCCTATTAATGGAA -> TGCTGCCTATTAATGGAAA
CTGGACCAAGGCAAAATAC -> TGGACCAAGGCAAAATACT
CTGGACTGGGTTCAAGGTG -> TGGACTGGGTTCAAGGTGT
CTGGATACGCCACAAGAAC -> TGGATACGCCACAAGAACA
CTGGATACGCCAGGAAGCT -> TGGATACGCCAGGAAGCTG
CTGGCTTGCGGCAAACTGT -> TGGCTTGCGGCAAACTGTT
CTGGGAATCAGCACATGAT -> TGGGAATCAGCACATGATT
CTGGGAGCGGCAGATCGGC -> TGGGAGCGGCAGATCGGCG
CTGGGGCGAAGAATCTCCG -> TGGGGCGAAGAATCTCCGA
CTGGGGGGCCCCTCTCTCT -> TGGGGGGCCCCTCTCTCTG
CTGGGTTCAAGGTGTGCTC -> TGGGTTCAAGGTGTGCTCT
CTGGGTTCACGCCAATACG -> TGGGTTCACGCCAATACGA
CTGGTCACCAATAACGGTC -> TGGTCACCAATAACGGTCA
CTGTACATCCCTATCGGCA -> TGTACATCCCTATCGGCAG
CTGTGCACACTCCGGTGAT -> TGTGCACACTCCGGTGATG
CTGTTATCTGAACAATTAA -> TGTTATCTGAACAATTAAG
CTGTTATCTGAACACGGAC -> TGTTATCTGAACACGGACT
CTGTTATCTGAACAGCGTA -> TGTTATCTGAACAGCGTAC
CTGTTATCTGAACATCGTG -> TGTTATCTGAACATCGTGG
CTGTTGTCGTACTATCATT -> TGTTGTCGTACTATCATTG
CTGTTTAACTTGATCTGAC -> TGTTTAACTTGATCTGACG
CTTAACGGTAGTCCTTCGT -> TTAACGGTAGTCCTTCGTT
CTTACGCTTCACTTGCGAC -> TTACGCTTCACTTGCGACA
CTTAGCACTCCAGACAGCG -> TTAGCACTCCAGACAGCGC
CTTAGCGATGCCTGGACTG -> TTAGCGATGCCTGGACTGG
CTTATACTTAGCACTCCAG -> TTATACTTAGCACTCCAGA
CTTATGTACGCTGGGTTCA -> TTATGTACGCTGGGTTCAC
CTTATTGATTCTTATGTAC -> TTATTGATTCTTATGTACG
CTTCACTTGCGACACCGGG -> TTCACTTGCGACACCGGGT
CTTCCCAGGAGTCAGGCTA -> TTCCCAGGAGTCAGGCTAA
CTTCCCTAGATCATGCGAA -> TTCCCTAGATCATGCGAAC
CTTCCGTTTCAGTATTGAC -> TTCCGTTTCAGTATTGACC
CTTCGCGATCTTAGTGGCA -> TTCGCGATCTTAGTGGCAG
CTTCGCTTCTTCTGATATT -> TTCGCTTCTTCTGATATTG
CTTCGTTCAAACTGTTATC -> TTCGTTCAAACTGTTATCT
CTTCTGATATTGAGGATTG -> TTCTGATATTGAGGATTGG
CTTCTGTGCACACTCCGGT -> TTCTGTGCACACTCCGGTG
CTTCTTCTGATATTGAGGA -> TTCTTCTGATATTGAGGAT
CTTGACCCCGCATAGTAAG -> TTGACCCCGCATAGTAAGA
CTTGATCTGACGCTGCTGC -> TTGATCTGACGCTGCTGCC
CTTGCGACACCGGGTATAT -> TTGCGACACCGGGTATATA
CTTGCGGCAAACTGTTATC -> TTGCGGCAAACTGTTATCT
CTTGCGGTGGGTTAGTAAT -> TTGCGGTGGGTTAGTAATC
CTTGGCAGACTCGTGTAGG -> TTGGCAGACTCGTGTAGGA
CTTGGCCTTTAACGGAGCC -> TTGGCCTTTAACGGAGCCT
CTTGGTGCATCGCTAAACG -> TTGGTGCATCGCTAAACGT
CTTGGTGCATCGCTAAACT -> TTGGTGCATCGCTAAACTG
CTTGGTGCATCGCTAAGCG -> TTGGTGCATCGCTAAGCGG
CTTGGTGCATCGCTAATAA -> TTGGTGCATCGCTAATAAG
CTTGTAGTGTGAGGACTTT -> TTGTAGTGTGAGGACTTTC
CTTGTGTTTGGGACCACGT -> TTGTGTTTGGGACCACGTA
CTTTAACGGAGCCTTAACG -> TTTAACGGAGCCTTAACGG
CTTTCACGCGTTAATAGGT -> TTTCACGCGTTAATAGGTG
CTTTCCCCTTGGCCTTTAA -> TTTCCCCTTGGCCTTTAAC
CTTTCCCGAGTAAAAGATG -> TTTCCCGAGTAAAAGATGA
CTTTCGCTACCATCGTGCG -> TTTCGCTACCATCGTGCGC
CTTTCTCCATCGGAGGACT -> TTTCTCCATCGGAGGACTG
CTTTGTAGAGGGACGATCT -> TTTGTAGAGGGACGATCTC
CTTTTACCTTGCGGTGGGT -> TTTTACCTTGCGGTGGGTT
GAAAAGAATCCAAGATGCA -> AAAAGAATCCAAGATGCAT
GAAAAGGCCCCAATCGAAA -> AAAAGGCCCCAATCGAAAT
GAAAAGGCGATCGTATATT -> AAAAGGCGATCGTATATTT
GAAACAAGAAGACTTTCGC -> AAACAAGAAGACTTTCGCT
GAAAGGTGGATGTCGCACA -> AAAGGTGGATGTCGCACAC
GAAATAGCAATTTTAAGAT -> AAATAGCAATTTTAAGATC
GAACAATTAAGGTTCTAGA -> AACAATTAAGGTTCTAGAC
GAACACGGACTCCATAAGA -> AACACGGACTCCATAAGAC
GAACAGCGTACAGACGAGA -> AACAGCGTACAGACGAGAC
GAACAGGGTAGATCCTCGT -> AACAGGGTAGATCCTCGTA
GAACATCGTGGAGCCAAGA -> AACATCGTGGAGCCAAGAC
GAACCGAAAAGAATCCAAG -> AACCGAAAAGAATCCAAGA
GAACCTCCCATCTGTTTAA -> AACCTCCCATCTGTTTAAC
GAACGTACAGAGGCGAAGA -> AACGTACAGAGGCGAAGAT
GAACTCCACAACGCGTCCC -> AACTCCACAACGCGTCCCC
GAAGAATCTCCGAAGGCAC -> AAGAATCTCCGAAGGCACG
GAAGACTTTCGCTACCATC -> AAGACTTTCGCTACCATCG
GAAGAGTATATCCAGAGAC -> AAGAGTATATCCAGAGACG
GAAGATGTCACGGCCAAAC -> AAGATGTCACGGCCAAACT
GAAGCTGTTGTCGTACTAT -> AAGCTGTTGTCGTACTATC
GAAGGATTCTAAACAGGCG -> AAGGATTCTAAACAGGCGA
GAAGGCACGCTTTCTCCAT -> AAGGCACGCTTTCTCCATC
GAATCAGAGCAACATTGAA -> AATCAGAGCAACATTGAAC
GAATCAGCACATGATTTCG -> AATCAGCACATGATTTCGG
GAATCCAAGATGCATGGCG -> AATCCAAGATGCATGGCGA
GAATCCAGTTACGCTGACC -> AATCCAGTTACGCTGACCT
GAATCTCCGAAGGCACGCT -> AATCTCCGAAGGCACGCTT
GAATTAGCCATGGCGCCTA -> AATTAGCCATGGCGCCTAC
GACACAATGATCAGCCTCA -> ACACAATGATCAGCCTCAT
GACACCATAATCTTCGCGA -> ACACCATAATCTTCGCGAT
GACACCGGGTATATAGCTA -> ACACCGGGTATATAGCTAC
GACACTGGTCACCAATAAC -> ACACTGGTCACCAATAACG
GACAGCGCGCTTCCGTTTC -> ACAGCGCGCTTCCGTTTCA
GACATACGGACGTCGTGCG -> ACATACGGACGTCGTGCGA
GACATCCCCCAGCGAGTAA -> ACATCCCCCAGCGAGTAAG
GACATGTAAGTCATGGAGG -> ACATGTAAGTCATGGAGGC
GACATTCGGAGTGGATAAA -> ACATTCGGAGTGGATAAAT
GACCAAGGCAAAATACTAC -> ACCAAGGCAAAATACTACC
GACCACGCTTACGCTTCAC -> ACCACGCTTACGCTTCACT
GACCACGTAAGCCGTACCC -> ACCACGTAAGCCGTACCCT
GACCAGGTTCCACAAACTG -> ACCAGGTTCCACAAACTGT
GACCCAAATCTCACTGGAT -> ACCCAAATCTCACTGGATA
GACCCAACTAACAGGGTTC -> ACCCAACTAACAGGGTTCC
GACCCCGCATAGTAAGACC -> ACCCCGCATAGTAAGACCC
GACCGTCGAGACACTGGTC -> ACCGTCGAGACACTGGTCA
GACCTATATGCGATTTGCC -> ACCTATATGCGATTTGCCT
GACCTTCGCTTCTTCTGAT -> ACCTTCGCTTCTTCTGATA
GACGACCAGGTTCCACAAA -> ACGACCAGGTTCCACAAAC
GACGAGACTTGGTGCATCG -> ACGAGACTTGGTGCATCGC
GACGATAAATAATTTTGGC -> ACGATAAATAATTTTGGCG
GACGATCTCGAACCTCCCA -> ACGATCTCGAACCTCCCAT
GACGCACTTATACTTAGCA -> ACGCACTTATACTTAGCAC
GACGCTGACACAATGATCA -> ACGCTGACACAATGATCAG
GACGCTGCTGCCTATTAAT -> ACGCTGCTGCCTATTAATG
GACGTAGATACAAGCCTAT -> ACGTAGATACAAGCCTATG
GACGTCGTGCGATGCATAC -> ACGTCGTGCGATGCATACC
GACGTGGTCAAGAACCGAA -> ACGTGGTCAAGAACCGAAA
GACGTTGGACATCCCCCAG -> ACGTTGGACATCCCCCAGC
GACTATGGATTCGTAATGA -> ACTATGGATTCGTAATGAC
GACTATTCGCTAACCATAA -> ACTATTCGCTAACCATAAA
GACTCACCTAGGTTGATTG -> ACTCACCTAGGTTGATTGC
GACTCCATAAGACTTGGTG -> ACTCCATAAGACTTGGTGC
GACTCGTAGCGAGCGGATT -> ACTCGTAGCGAGCGGATTA
GACTCGTGTAGGAGTCCTC -> ACTCGTGTAGGAGTCCTCA
GACTGATGTGTAACTCTAG -> ACTGATGTGTAACTCTAGT
GACTGGCTTGCGGCAAACT -> ACTGGCTTGCGGCAAACTG
GACTGGGTTCAAGGTGTGC -> ACTGGGTTCAAGGTGTGCT
GACTTCCCTAGATCATGCG -> ACTTCCCTAGATCATGCGA
GACTTGGTGCATCGCTAAA -> ACTTGGTGCATCGCTAAAC,ACTTGGTGCATCGCTAAAC
GACTTGGTGCATCGCTAAG -> ACTTGGTGCATCGCTAAGC
GACTTGGTGCATCGCTAAT -> ACTTGGTGCATCGCTAATA
GACTTGTAGTGTGAGGACT -> ACTTGTAGTGTGAGGACTT
GACTTTCCCCTTGGCCTTT -> ACTTTCCCCTTGGCCTTTA
GACTTTCGCTACCATCGTG -> ACTTTCGCTACCATCGTGC
GAGACACTGGTCACCAATA -> AGACACTGGTCACCAATAA
GAGACATACGGACGTCGTG -> AGACATACGGACGTCGTGC
GAGACGACCAGGTTCCACA -> AGACGACCAGGTTCCACAA
GAGACGCACTTATACTTAG -> AGACGCACTTATACTTAGC
GAGACTTGGTGCATCGCTA -> AGACTTGGTGCATCGCTAA
GAGAGGACCTTCGCTTCTT -> AGAGGACCTTCGCTTCTTC
GAGATCAAGGGATCTGGGG -> AGATCAAGGGATCTGGGGG
GAGCAACATTGAACGTACA -> AGCAACATTGAACGTACAG
GAGCACGTATAACAGCGTT -> AGCACGTATAACAGCGTTT
GAGCCAAGACTTGGTGCAT -> AGCCAAGACTTGGTGCATC
GAGCCTTAACGGTAGTCCT -> AGCCTTAACGGTAGTCCTT
GAGCGCTAAGGTCTAGGCC -> AGCGCTAAGGTCTAGGCCG
GAGCGGATTAGACGTAGAT -> AGCGGATTAGACGTAGATA
GAGCGGCAGATCGGCGGAC -> AGCGGCAGATCGGCGGACG
GAGGACCTTCGCTTCTTCT -> AGGACCTTCGCTTCTTCTG
GAGGACTGGCTTGCGGCAA -> AGGACTGGCTTGCGGCAAA
GAGGACTTTCCCCTTGGCC -> AGGACTTTCCCCTTGGCCT
GAGGATTGGAGCACGTATA -> AGGATTGGAGCACGTATAA
GAGGCATCTGTACATCCCT -> AGGCATCTGTACATCCCTA
GAGGCCAACATTGGATAAT -> AGGCCAACATTGGATAATC
GAGGCGAAGATGTCACGGC -> AGGCGAAGATGTCACGGCC
GAGGGACGATCTCGAACCT -> AGGGACGATCTCGAACCTC
GAGTAAAAGATGACCACGC -> AGTAAAAGATGACCACGCT
GAGTAAGCGCAGCTTTTAC -> AGTAAGCGCAGCTTTTACC
GAGTATATCCAGAGACGCA -> AGTATATCCAGAGACGCAC
GAGTCAGGCTAAGTCTTTG -> AGTCAGGCTAAGTCTTTGT
GAGTCCTCAAATTGCGGCA -> AGTCCTCAAATTGCGGCAT
GAGTCGCTTATTGATTCTT -> AGTCGCTTATTGATTCTTA
GAGTGGATAAATGTAGATT -> AGTGGATAAATGTAGATTC
GAGTTCCCGGGTTTCTCGT -> AGTTCCCGGGTTTCTCGTG
GATAAATAATTTTGGCGGT -> ATAAATAATTTTGGCGGTA
GATAAATGTAGATTCCTTC -> ATAAATGTAGATTCCTTCT
GATAATCCTTCCCAGGAGT -> ATAATCCTTCCCAGGAGTC
GATACAAGCCTATGTCAAT -> ATACAAGCCTATGTCAATT
GATACGCCACAAGAACAGG -> ATACGCCACAAGAACAGGG
GATACGCCAGGAAGCTGTT -> ATACGCCAGGAAGCTGTTG
GATAGGGGGTAATTAACCA -> ATAGGGGGTAATTAACCAC
GATAGTGTACTATTTGGAT -> ATAGTGTACTATTTGGATT
GATATATCTTGTGTTTGGG -> ATATATCTTGTGTTTGGGA
GATATTGAGGATTGGAGCA -> ATATTGAGGATTGGAGCAC
GATCAAGGGATCTGGGGGG -> ATCAAGGGATCTGGGGGGC
GATCAGAATCAGAGCAACA -> ATCAGAATCAGAGCAACAT
GATCAGCCTCATCTGGATA -> ATCAGCCTCATCTGGATAC
GATCATGCGAACTCCACAA -> ATCATGCGAACTCCACAAC
GATCCATCCTCCGTTATAG -> ATCCATCCTCCGTTATAGT
GATCCTCGTAGGGGGGTGT -> ATCCTCGTAGGGGGGTGTA
GATCGGACTTCCCTAGATC -> ATCGGACTTCCCTAGATCA
GATCGGCGGACGCTGACAC -> ATCGGCGGACGCTGACACA
GATCGTATATTTATGTCAG -> ATCGTATATTTATGTCAGC
GATCTCGAACCTCCCATCT -> ATCTCGAACCTCCCATCTG
GATCTGACGCTGCTGCCTA -> ATCTGACGCTGCTGCCTAT
GATCTGGGGGGCCCCTCTC -> ATCTGGGGGGCCCCTCTCT
GATGAAAAGGCCCCAATCG -> ATGAAAAGGCCCCAATCGA
GATGACCACGCTTACGCTT -> ATGACCACGCTTACGCTTC
GATGCATACCCTAACGCAA -> ATGCATACCCTAACGCAAG
GATGCATGGCGACTGATGT -> ATGCATGGCGACTGATGTG
GATGCCTGGACTGGGTTCA -> ATGCCTGGACTGGGTTCAA
GATGGCACTCGCCAGCAAA -> ATGGCACTCGCCAGCAAAA
GATGTCACGGCCAAACTGT -> ATGTCACGGCCAAACTGTT
GATGTCGCACACAGGTGAC -> ATGTCGCACACAGGTGACG
GATGTGTAACTCTAGTGAC -> ATGTGTAACTCTAGTGACT
GATTAGACGTAGATACAAG -> ATTAGACGTAGATACAAGC
GATTCCTTCTGTGCACACT -> ATTCCTTCTGTGCACACTC
GATTCGTAATGACACCATA -> ATTCGTAATGACACCATAA
GATTCTAAACAGGCGAGAC -> ATTCTAAACAGGCGAGACG
GATTCTTATGTACGCTGGG -> ATTCTTATGTACGCTGGGT
GATTGCGGGATGGCACTCG -> ATTGCGGGATGGCACTCGC
GATTGCGGTAAGTGCTCGC -> ATTGCGGTAAGTGCTCGCC
GATTGGAGCACGTATAACA -> ATTGGAGCACGTATAACAG
GATTTCGGGGATCCATCCT -> ATTTCGGGGATCCATCCTC
GATTTGCCTCCGTCTGACC -> ATTTGCCTCCGTCTGACCG
GATTTGTTAATCGGCTGCT -> ATTTGTTAATCGGCTGCTC
GATTTTGCGAAAAGGCGAT -> ATTTTGCGAAAAGGCGATC
GATTTTTGGGGGTACGGTC -> ATTTTTGGGGGTACGGTCT
GCAAAATACTACCTAAGGA -> CAAAATACTACCTAAGGAT
GCAAAATCTCAGCATAGGA -> CAAAATCTCAGCATAGGAC
GCAAACTGTTATCTGAACA -> CAAACTGTTATCTGAACAG
GCAACATTGAACGTACAGA -> CAACATTGAACGTACAGAG
GCAAGCTAACTTTCACGCG -> CAAGCTAACTTTCACGCGT
GCAATTTTAAGATCAGAAT -> CAATTTTAAGATCAGAATC
GCACACAGGTGACGTGGTC -> CACACAGGTGACGTGGTCA
GCACACTCCGGTGATGAAA -> CACACTCCGGTGATGAAAA
GCACATGATTTCGGGGATC -> CACATGATTTCGGGGATCC
GCACCGAAAGGTGGATGTC -> CACCGAAAGGTGGATGTCG
GCACGCCCTGCGACTCACC -> CACGCCCTGCGACTCACCT
GCACGCTTTCTCCATCGGA -> CACGCTTTCTCCATCGGAG
GCACGTATAACAGCGTTTA -> CACGTATAACAGCGTTTAT
GCACTCCAGACAGCGCGCT -> CACTCCAGACAGCGCGCTT
GCACTCGCCAGCAAAATCT -> CACTCGCCAGCAAAATCTC
GCACTTATACTTAGCACTC -> CACTTATACTTAGCACTCC
GCAGACTCGTGTAGGAGTC -> CAGACTCGTGTAGGAGTCC
GCAGATCGGACTTCCCTAG -> CAGATCGGACTTCCCTAGA
GCAGATCGGCGGACGCTGA -> CAGATCGGCGGACGCTGAC
GCAGCTTTTACCTTGCGGT -> CAGCTTTTACCTTGCGGTG
GCATAACTGAGAGGACCTT -> CATAACTGAGAGGACCTTC
GCATACCCTAACGCAAGCT -> CATACCCTAACGCAAGCTA
GCATAGGACTTGTAGTGTG -> CATAGGACTTGTAGTGTGA
GCATAGTAAGACCCAAATC -> CATAGTAAGACCCAAATCT
GCATATCAAGTTCCTGCGA -> CATATCAAGTTCCTGCGAA
GCATCGACGTTGGACATCC -> CATCGACGTTGGACATCCC
GCATCGCTAAACGTTGAGT -> CATCGCTAAACGTTGAGTC
GCATCGCTAAACTGGGAGC -> CATCGCTAAACTGGGAGCG
GCATCGCTAAGCGGAGTTC -> CATCGCTAAGCGGAGTTCC
GCATCGCTAATAAGTGTTC -> CATCGCTAATAAGTGTTCA
GCATCTGTACATCCCTATC -> CATCTGTACATCCCTATCG
GCATGGCGACTGATGTGTA -> CATGGCGACTGATGTGTAA
GCATTCTTGACCCCGCATA -> CATTCTTGACCCCGCATAG
GCCAAACTGTTATCTGAAC -> CCAAACTGTTATCTGAACA
GCCAACATTGGATAATCCT -> CCAACATTGGATAATCCTT
GCCAAGACTTGGTGCATCG -> CCAAGACTTGGTGCATCGC
GCCAATACGATTTTGCGAA -> CCAATACGATTTTGCGAAA
GCCACAAGAACAGGGTAGA -> CCACAAGAACAGGGTAGAT
GCCACTCGGGACTCGTAGC -> CCACTCGGGACTCGTAGCG
GCCAGCAAAATCTCAGCAT -> CCAGCAAAATCTCAGCATA
GCCAGGAAGCTGTTGTCGT -> CCAGGAAGCTGTTGTCGTA
GCCATATTAGCATAACTGA -> CCATATTAGCATAACTGAG
GCCATGGCGCCTACCCTTG -> CCATGGCGCCTACCCTTGG
GCCCCAATCGAAATAGCAA -> CCCCAATCGAAATAGCAAT
GCCCCTCTCTCTGGGAATC -> CCCCTCTCTCTGGGAATCA
GCCCTGCGACTCACCTAGG -> CCCTGCGACTCACCTAGGT
GCCGCACGCCCTGCGACTC -> CCGCACGCCCTGCGACTCA
GCCGCCTTTCCCGAGTAAA -> CCGCCTTTCCCGAGTAAAA
GCCGGTTATAGCGCCATAT -> CCGGTTATAGCGCCATATT
GCCGTAAAAAAGTCACAAG -> CCGTAAAAAAGTCACAAGG
GCCGTACCCTGGACCAAGG -> CCGTACCCTGGACCAAGGC
GCCTACCCTTGGCAGACTC -> CCTACCCTTGGCAGACTCG
GCCTATGTCAATTCAGCCG -> CCTATGTCAATTCAGCCGG
GCCTATTAATGGAAACAAG -> CCTATTAATGGAAACAAGA
GCCTCATCTGGATACGCCA -> CCTCATCTGGATACGCCAC
GCCTCCGTCTGACCGTCGA -> CCTCCGTCTGACCGTCGAG
GCCTGGACTGGGTTCAAGG -> CCTGGACTGGGTTCAAGGT
GCCTTAACGGTAGTCCTTC -> CCTTAACGGTAGTCCTTCG
GCCTTAGCGATGCCTGGAC -> CCTTAGCGATGCCTGGACT
GCCTTTAACGGAGCCTTAA -> CCTTTAACGGAGCCTTAAC
GCCTTTCCCGAGTAAAAGA -> CCTTTCCCGAGTAAAAGAT
GCGAAAAGGCGATCGTATA -> CGAAAAGGCGATCGTATAT
GCGAACTCCACAACGCGTC -> CGAACTCCACAACGCGTCC
GCGAAGAATCTCCGAAGGC -> CGAAGAATCTCCGAAGGCA
GCGAAGATGTCACGGCCAA -> CGAAGATGTCACGGCCAAA
GCGAAGGATTCTAAACAGG -> CGAAGGATTCTAAACAGGC
GCGAATCCAGTTACGCTGA -> CGAATCCAGTTACGCTGAC
GCGACACCGGGTATATAGC -> CGACACCGGGTATATAGCT
GCGACTCACCTAGGTTGAT -> CGACTCACCTAGGTTGATT
GCGACTGATGTGTAACTCT -> CGACTGATGTGTAACTCTA
GCGAGACGACCAGGTTCCA -> CGAGACGACCAGGTTCCAC
GCGAGCGGATTAGACGTAG -> CGAGCGGATTAGACGTAGA
GCGAGTAAGCGCAGCTTTT -> CGAGTAAGCGCAGCTTTTA
GCGATATATCTTGTGTTTG -> CGATATATCTTGTGTTTGG
GCGATCGTATATTTATGTC -> CGATCGTATATTTATGTCA
GCGATGCATACCCTAACGC -> CGATGCATACCCTAACGCA
GCGATGCCTGGACTGGGTT -> CGATGCCTGGACTGGGTTC
GCGATTTGCCTCCGTCTGA -> CGATTTGCCTCCGTCTGAC
GCGCAGCTTTTACCTTGCG -> CGCAGCTTTTACCTTGCGG
GCGCATTCTTGACCCCGCA -> CGCATTCTTGACCCCGCAT
GCGCCATATTAGCATAACT -> CGCCATATTAGCATAACTG
GCGCCTACCCTTGGCAGAC -> CGCCTACCCTTGGCAGACT
GCGCGCTTCCGTTTCAGTA -> CGCGCTTCCGTTTCAGTAT
GCGCTAAGGTCTAGGCCGC -> CGCTAAGGTCTAGGCCGCC
GCGCTTCCGTTTCAGTATT -> CGCTTCCGTTTCAGTATTG
GCGGACGCTGACACAATGA -> CGGACGCTGACACAATGAT
GCGGAGTTCCCGGGTTTCT -> CGGAGTTCCCGGGTTTCTC
GCGGATTAGACGTAGATAC -> CGGATTAGACGTAGATACA
GCGGCAAACTGTTATCTGA -> CGGCAAACTGTTATCTGAA
GCGGCAGATCGGCGGACGC -> CGGCAGATCGGCGGACGCT
GCGGCATCGACGTTGGACA -> CGGCATCGACGTTGGACAT
GCGGGATGGCACTCGCCAG -> CGGGATGGCACTCGCCAGC
GCGGTAAGTGCTCGCCGCA -> CGGTAAGTGCTCGCCGCAC
GCGGTATACGCTGCCGTAA -> CGGTATACGCTGCCGTAAA
GCGGTCATTACCAGTCCGC -> CGGTCATTACCAGTCCGCC
GCGGTGGGTTAGTAATCAG -> CGGTGGGTTAGTAATCAGT
GCGTACAGACGAGACTTGG -> CGTACAGACGAGACTTGGT
GCGTCCCCAAGTGTGCATA -> CGTCCCCAAGTGTGCATAT
GCGTTAATAGGTGATTTGT -> CGTTAATAGGTGATTTGTT
GCGTTTATGGGCGGTCATT -> CGTTTATGGGCGGTCATTA
GCTAAACGTTGAGTCGCTT -> CTAAACGTTGAGTCGCTTA
GCTAAACTGGGAGCGGCAG -> CTAAACTGGGAGCGGCAGA
GCTAACCATAAACAGTCCC -> CTAACCATAAACAGTCCCA
GCTAACTTTCACGCGTTAA -> CTAACTTTCACGCGTTAAT
GCTAAGCGGAGTTCCCGGG -> CTAAGCGGAGTTCCCGGGT
GCTAAGGTCTAGGCCGCCT -> CTAAGGTCTAGGCCGCCTT
GCTAAGTCTTTGTAGAGGG -> CTAAGTCTTTGTAGAGGGA
GCTAATAAGTGTTCAGGAG -> CTAATAAGTGTTCAGGAGG
GCTACCATCGTGCGCATTC -> CTACCATCGTGCGCATTCT
GCTACCTCAAAGACGATAA -> CTACCTCAAAGACGATAAA
GCTCGCCGCACGCCCTGCG -> CTCGCCGCACGCCCTGCGA
GCTCTCTGACATGTAAGTC -> CTCTCTGACATGTAAGTCA
GCTCTGGGGCGAAGAATCT -> CTCTGGGGCGAAGAATCTC
GCTGACACAATGATCAGCC -> CTGACACAATGATCAGCCT
GCTGACCTATATGCGATTT -> CTGACCTATATGCGATTTG
GCTGCCGTAAAAAAGTCAC -> CTGCCGTAAAAAAGTCACA
GCTGCCTATTAATGGAAAC -> CTGCCTATTAATGGAAACA
GCTGCTCTGGGGCGAAGAA -> CTGCTCTGGGGCGAAGAAT
GCTGCTGCCTATTAATGGA -> CTGCTGCCTATTAATGGAA
GCTGGGTTCACGCCAATAC -> CTGGGTTCACGCCAATACG
GCTGTTGTCGTACTATCAT -> CTGTTGTCGTACTATCATT
GCTTACGCTTCACTTGCGA -> CTTACGCTTCACTTGCGAC
GCTTATTGATTCTTATGTA -> CTTATTGATTCTTATGTAC
GCTTCACTTGCGACACCGG -> CTTCACTTGCGACACCGGG
GCTTCCGTTTCAGTATTGA -> CTTCCGTTTCAGTATTGAC
GCTTCTTCTGATATTGAGG -> CTTCTTCTGATATTGAGGA
GCTTGCGGCAAACTGTTAT -> CTTGCGGCAAACTGTTATC
GCTTTCTCCATCGGAGGAC -> CTTTCTCCATCGGAGGACT
GCTTTTACCTTGCGGTGGG -> CTTTTACCTTGCGGTGGGT
GGAAACAAGAAGACTTTCG -> GAAACAAGAAGACTTTCGC
GGAAGCTGTTGTCGTACTA -> GAAGCTGTTGTCGTACTAT
GGAATCAGCACATGATTTC -> GAATCAGCACATGATTTCG
GGACATCCCCCAGCGAGTA -> GACATCCCCCAGCGAGTAA
GGACATTCGGAGTGGATAA -> GACATTCGGAGTGGATAAA
GGACCAAGGCAAAATACTA -> GACCAAGGCAAAATACTAC
GGACCACGTAAGCCGTACC -> GACCACGTAAGCCGTACCC
GGACCTTCGCTTCTTCTGA -> GACCTTCGCTTCTTCTGAT
GGACGATCTCGAACCTCCC -> GACGATCTCGAACCTCCCA
GGACGCTGACACAATGATC -> GACGCTGACACAATGATCA
GGACGTCGTGCGATGCATA -> GACGTCGTGCGATGCATAC
GGACTATTCGCTAACCATA -> GACTATTCGCTAACCATAA
GGACTCCATAAGACTTGGT -> GACTCCATAAGACTTGGTG
GGACTCGTAGCGAGCGGAT -> GACTCGTAGCGAGCGGATT
GGACTGGCTTGCGGCAAAC -> GACTGGCTTGCGGCAAACT
GGACTGGGTTCAAGGTGTG -> GACTGGGTTCAAGGTGTGC
GGACTTCCCTAGATCATGC -> GACTTCCCTAGATCATGCG
GGACTTGTAGTGTGAGGAC -> GACTTGTAGTGTGAGGACT
GGACTTTCCCCTTGGCCTT -> GACTTTCCCCTTGGCCTTT
GGAGACATACGGACGTCGT -> GAGACATACGGACGTCGTG
GGAGCACGTATAACAGCGT -> GAGCACGTATAACAGCGTT
GGAGCCAAGACTTGGTGCA -> GAGCCAAGACTTGGTGCAT
GGAGCCTTAACGGTAGTCC -> GAGCCTTAACGGTAGTCCT
GGAGCGGCAGATCGGCGGA -> GAGCGGCAGATCGGCGGAC
GGAGGACTGGCTTGCGGCA -> GAGGACTGGCTTGCGGCAA
GGAGGCATCTGTACATCCC -> GAGGCATCTGTACATCCCT
GGAGGCCAACATTGGATAA -> GAGGCCAACATTGGATAAT
GGAGTCAGGCTAAGTCTTT -> GAGTCAGGCTAAGTCTTTG
GGAGTCCTCAAATTGCGGC -> GAGTCCTCAAATTGCGGCA
GGAGTGGATAAATGTAGAT -> GAGTGGATAAATGTAGATT
GGAGTTCCCGGGTTTCTCG -> GAGTTCCCGGGTTTCTCGT
GGATAAATGTAGATTCCTT -> GATAAATGTAGATTCCTTC
GGATAATCCTTCCCAGGAG -> GATAATCCTTCCCAGGAGT
GGATACGCCACAAGAACAG -> GATACGCCACAAGAACAGG
GGATACGCCAGGAAGCTGT -> GATACGCCAGGAAGCTGTT
GGATAGGGGGTAATTAACC -> GATAGGGGGTAATTAACCA
GGATCCATCCTCCGTTATA -> GATCCATCCTCCGTTATAG
GGATCTGGGGGGCCCCTCT -> GATCTGGGGGGCCCCTCTC
GGATGGCACTCGCCAGCAA -> GATGGCACTCGCCAGCAAA
GGATGTCGCACACAGGTGA -> GATGTCGCACACAGGTGAC
GGATTAGACGTAGATACAA -> GATTAGACGTAGATACAAG
GGATTCGTAATGACACCAT -> GATTCGTAATGACACCATA
GGATTCTAAACAGGCGAGA -> GATTCTAAACAGGCGAGAC
GGATTGGAGCACGTATAAC -> GATTGGAGCACGTATAACA
GGATTTTTGGGGGTACGGT -> GATTTTTGGGGGTACGGTC
GGCAAAATACTACCTAAGG -> GCAAAATACTACCTAAGGA
GGCAAACTGTTATCTGAAC -> GCAAACTGTTATCTGAACA
GGCACGCTTTCTCCATCGG -> GCACGCTTTCTCCATCGGA
GGCACTCGCCAGCAAAATC -> GCACTCGCCAGCAAAATCT
GGCAGACTCGTGTAGGAGT -> GCAGACTCGTGTAGGAGTC
GGCAGATCGGACTTCCCTA -> GCAGATCGGACTTCCCTAG
GGCAGATCGGCGGACGCTG -> GCAGATCGGCGGACGCTGA
GGCATCGACGTTGGACATC -> GCATCGACGTTGGACATCC
GGCATCTGTACATCCCTAT -> GCATCTGTACATCCCTATC
GGCCAAACTGTTATCTGAA -> GCCAAACTGTTATCTGAAC
GGCCAACATTGGATAATCC -> GCCAACATTGGATAATCCT
GGCCACTCGGGACTCGTAG -> GCCACTCGGGACTCGTAGC
GGCCCCAATCGAAATAGCA -> GCCCCAATCGAAATAGCAA
GGCCCCTCTCTCTGGGAAT -> GCCCCTCTCTCTGGGAATC
GGCCGCCTTTCCCGAGTAA -> GCCGCCTTTCCCGAGTAAA
GGCCTTTAACGGAGCCTTA -> GCCTTTAACGGAGCCTTAA
GGCGAAGAATCTCCGAAGG -> GCGAAGAATCTCCGAAGGC
GGCGAAGATGTCACGGCCA -> GCGAAGATGTCACGGCCAA
GGCGACTGATGTGTAACTC -> GCGACTGATGTGTAACTCT
GGCGAGACGACCAGGTTCC -> GCGAGACGACCAGGTTCCA
GGCGATCGTATATTTATGT -> GCGATCGTATATTTATGTC
GGCGCCTACCCTTGGCAGA -> GCGCCTACCCTTGGCAGAC
GGCGGACGCTGACACAATG -> GCGGACGCTGACACAATGA
GGCGGTATACGCTGCCGTA -> GCGGTATACGCTGCCGTAA
GGCGGTCATTACCAGTCCG -> GCGGTCATTACCAGTCCGC
GGCTAAGTCTTTGTAGAGG -> GCTAAGTCTTTGTAGAGGG
GGCTGCTCTGGGGCGAAGA -> GCTGCTCTGGGGCGAAGAA
GGCTTGCGGCAAACTGTTA -> GCTTGCGGCAAACTGTTAT
GGGAATCAGCACATGATTT -> GGAATCAGCACATGATTTC
GGGACCACGTAAGCCGTAC -> GGACCACGTAAGCCGTACC
GGGACGATCTCGAACCTCC -> GGACGATCTCGAACCTCCC
GGGACTCGTAGCGAGCGGA -> GGACTCGTAGCGAGCGGAT
GGGAGACATACGGACGTCG -> GGAGACATACGGACGTCGT
GGGAGCGGCAGATCGGCGG -> GGAGCGGCAGATCGGCGGA
GGGATCCATCCTCCGTTAT -> GGATCCATCCTCCGTTATA
GGGATCTGGGGGGCCCCTC -> GGATCTGGGGGGCCCCTCT
GGGATGGCACTCGCCAGCA -> GGATGGCACTCGCCAGCAA
GGGCCACTCGGGACTCGTA -> GGCCACTCGGGACTCGTAG
GGGCCCCTCTCTCTGGGAA -> GGCCCCTCTCTCTGGGAAT
GGGCGAAGAATCTCCGAAG -> GGCGAAGAATCTCCGAAGG
GGGCGGTCATTACCAGTCC -> GGCGGTCATTACCAGTCCG
GGGGAGACATACGGACGTC -> GGGAGACATACGGACGTCG
GGGGATCCATCCTCCGTTA -> GGGATCCATCCTCCGTTAT
GGGGCCCCTCTCTCTGGGA -> GGGCCCCTCTCTCTGGGAA
GGGGCGAAGAATCTCCGAA -> GGGCGAAGAATCTCCGAAG
GGGGGCCCCTCTCTCTGGG -> GGGGCCCCTCTCTCTGGGA
GGGGGGCCCCTCTCTCTGG -> GGGGGCCCCTCTCTCTGGG
GGGGGGTGTACGTCACCGA -> GGGGGTGTACGTCACCGAG
GGGGGTAATTAACCACTCT -> GGGGTAATTAACCACTCTG
GGGGGTACGGTCTATTGAG -> GGGGTACGGTCTATTGAGC
GGGGGTGTACGTCACCGAG -> GGGGTGTACGTCACCGAGA
GGGGTAATTAACCACTCTG -> GGGTAATTAACCACTCTGA
GGGGTACGGTCTATTGAGC -> GGGTACGGTCTATTGAGCG
GGGGTGTACGTCACCGAGA -> GGGTGTACGTCACCGAGAT
GGGTAATTAACCACTCTGA -> GGTAATTAACCACTCTGAT
GGGTACGGTCTATTGAGCG -> GGTACGGTCTATTGAGCGC
GGGTAGATCCTCGTAGGGG -> GGTAGATCCTCGTAGGGGG
GGGTATATAGCTACCTCAA -> GGTATATAGCTACCTCAAA
GGGTGTACGTCACCGAGAT -> GGTGTACGTCACCGAGATC
GGGTTAGTAATCAGTCACA -> GGTTAGTAATCAGTCACAT
GGGTTCAAGGTGTGCTCTC -> GGTTCAAGGTGTGCTCTCT
GGGTTCACGCCAATACGAT -> GGTTCACGCCAATACGATT
GGGTTCCAAGAATTAGCCA -> GGTTCCAAGAATTAGCCAT
GGGTTTCTCGTGGACTATT -> GGTTTCTCGTGGACTATTC
GGTAAGTGCTCGCCGCACG -> GTAAGTGCTCGCCGCACGC
GGTAATTAACCACTCTGAT -> GTAATTAACCACTCTGATA
GGTACGGTCTATTGAGCGC -> GTACGGTCTATTGAGCGCT
GGTAGATCCTCGTAGGGGG -> GTAGATCCTCGTAGGGGGG
GGTAGTCCTTCGTTCAAAC -> GTAGTCCTTCGTTCAAACT
GGTATACGCTGCCGTAAAA -> GTATACGCTGCCGTAAAAA
GGTATATAGCTACCTCAAA -> GTATATAGCTACCTCAAAG
GGTCAAGAACCGAAAAGAA -> GTCAAGAACCGAAAAGAAT
GGTCACCAATAACGGTCAT -> GTCACCAATAACGGTCATG
GGTCATGAAGAGTATATCC -> GTCATGAAGAGTATATCCA
GGTCATTACCAGTCCGCCT -> GTCATTACCAGTCCGCCTT
GGTCTAGGCCGCCTTTCCC -> GTCTAGGCCGCCTTTCCCG
GGTCTATCGCACCGAAAGG -> GTCTATCGCACCGAAAGGT
GGTCTATTGAGCGCTAAGG -> GTCTATTGAGCGCTAAGGT
GGTGACGTGGTCAAGAACC -> GTGACGTGGTCAAGAACCG
GGTGATGAAAAGGCCCCAA -> GTGATGAAAAGGCCCCAAT
GGTGATTTGTTAATCGGCT -> GTGATTTGTTAATCGGCTG
GGTGCATCGCTAAACGTTG -> GTGCATCGCTAAACGTTGA
GGTGCATCGCTAAACTGGG -> GTGCATCGCTAAACTGGGA
GGTGCATCGCTAAGCGGAG -> GTGCATCGCTAAGCGGAGT
GGTGCATCGCTAATAAGTG -> GTGCATCGCTAATAAGTGT
GGTGGATGTCGCACACAGG -> GTGGATGTCGCACACAGGT
GGTGGGTTAGTAATCAGTC -> GTGGGTTAGTAATCAGTCA
GGTGTACGTCACCGAGATC -> GTGTACGTCACCGAGATCA
GGTGTGCTCTCTGACATGT -> GTGTGCTCTCTGACATGTA
GGTTAGTAATCAGTCACAT -> GTTAGTAATCAGTCACATT
GGTTATAGCGCCATATTAG -> GTTATAGCGCCATATTAGC
GGTTCAAGGTGTGCTCTCT -> GTTCAAGGTGTGCTCTCTG
GGTTCACGCCAATACGATT -> GTTCACGCCAATACGATTT
GGTTCCAAGAATTAGCCAT -> GTTCCAAGAATTAGCCATG
GGTTCCACAAACTGTTATC -> GTTCCACAAACTGTTATCT
GGTTCTAGACTTGGTGCAT -> GTTCTAGACTTGGTGCATC
GGTTGATTGCGGGATGGCA -> GTTGATTGCGGGATGGCAC
GGTTTCTCGTGGACTATTC -> GTTTCTCGTGGACTATTCG
GTAAAAAAGTCACAAGGAC -> TAAAAAAGTCACAAGGACA
GTAAAAGATGACCACGCTT -> TAAAAGATGACCACGCTTA
GTAACTCTAGTGACTATGG -> TAACTCTAGTGACTATGGA
GTAAGACCCAAATCTCACT -> TAAGACCCAAATCTCACTG
GTAAGCCGTACCCTGGACC -> TAAGCCGTACCCTGGACCA
GTAAGCGCAGCTTTTACCT -> TAAGCGCAGCTTTTACCTT
GTAAGTCATGGAGGCCAAC -> TAAGTCATGGAGGCCAACA
GTAAGTCGGTCTATCGCAC -> TAAGTCGGTCTATCGCACC
GTAAGTGCTCGCCGCACGC -> TAAGTGCTCGCCGCACGCC
GTAATCAGTCACATTACAG -> TAATCAGTCACATTACAGA
GTAATGACACCATAATCTT -> TAATGACACCATAATCTTC
GTAATTAACCACTCTGATA -> TAATTAACCACTCTGATAG
GTACAGACGAGACTTGGTG -> TACAGACGAGACTTGGTGC
GTACAGAGGCGAAGATGTC -> TACAGAGGCGAAGATGTCA
GTACATCCCTATCGGCAGA -> TACATCCCTATCGGCAGAT
GTACCCTGGACCAAGGCAA -> TACCCTGGACCAAGGCAAA
GTACGCTGGGTTCACGCCA -> TACGCTGGGTTCACGCCAA
GTACGGTCTATTGAGCGCT -> TACGGTCTATTGAGCGCTA
GTACGTCACCGAGATCAAG -> TACGTCACCGAGATCAAGG
GTACTATCATTGGGGAGAC -> TACTATCATTGGGGAGACA
GTACTATTTGGATTTTTGG -> TACTATTTGGATTTTTGGG
GTAGAGGGACGATCTCGAA -> TAGAGGGACGATCTCGAAC
GTAGATACAAGCCTATGTC -> TAGATACAAGCCTATGTCA
GTAGATCCTCGTAGGGGGG -> TAGATCCTCGTAGGGGGGT
GTAGATTCCTTCTGTGCAC -> TAGATTCCTTCTGTGCACA
GTAGCGAGCGGATTAGACG -> TAGCGAGCGGATTAGACGT
GTAGGAGTCCTCAAATTGC -> TAGGAGTCCTCAAATTGCG
GTAGGGGGGTGTACGTCAC -> TAGGGGGGTGTACGTCACC
GTAGTCCTTCGTTCAAACT -> TAGTCCTTCGTTCAAACTG
GTAGTGTGAGGACTTTCCC -> TAGTGTGAGGACTTTCCCC
GTATAACAGCGTTTATGGG -> TATAACAGCGTTTATGGGC
GTATACGCTGCCGTAAAAA -> TATACGCTGCCGTAAAAAA
GTATATAGCTACCTCAAAG -> TATATAGCTACCTCAAAGA
GTATATCCAGAGACGCACT -> TATATCCAGAGACGCACTT
GTATATTTATGTCAGCGAT -> TATATTTATGTCAGCGATA
GTATTGACCCAACTAACAG -> TATTGACCCAACTAACAGG
GTCAAGAACCGAAAAGAAT -> TCAAGAACCGAAAAGAATC
GTCAATTCAGCCGGTTATA -> TCAATTCAGCCGGTTATAG
GTCACAAGGACATTCGGAG -> TCACAAGGACATTCGGAGT
GTCACATTACAGATTGCGG -> TCACATTACAGATTGCGGT
GTCACCAATAACGGTCATG -> TCACCAATAACGGTCATGA
GTCACCGAGATCAAGGGAT -> TCACCGAGATCAAGGGATC
GTCACGGCCAAACTGTTAT -> TCACGGCCAAACTGTTATC
GTCAGCGATATATCTTGTG -> TCAGCGATATATCTTGTGT
GTCAGGCTAAGTCTTTGTA -> TCAGGCTAAGTCTTTGTAG
GTCATGAAGAGTATATCCA -> TCATGAAGAGTATATCCAG
GTCATGGAGGCCAACATTG -> TCATGGAGGCCAACATTGG
GTCATTACCAGTCCGCCTT -> TCATTACCAGTCCGCCTTA
GTCCCAGGGCCACTCGGGA -> TCCCAGGGCCACTCGGGAC
GTCCCCAAGTGTGCATATC -> TCCCCAAGTGTGCATATCA
GTCCGCCTTAGCGATGCCT -> TCCGCCTTAGCGATGCCTG
GTCCTCAAATTGCGGCATC -> TCCTCAAATTGCGGCATCG
GTCCTTCGTTCAAACTGTT -> TCCTTCGTTCAAACTGTTA
GTCGAGACACTGGTCACCA -> TCGAGACACTGGTCACCAA
GTCGCACACAGGTGACGTG -> TCGCACACAGGTGACGTGG
GTCGCTTATTGATTCTTAT -> TCGCTTATTGATTCTTATG
GTCGGTCTATCGCACCGAA -> TCGGTCTATCGCACCGAAA
GTCGTACTATCATTGGGGA -> TCGTACTATCATTGGGGAG
GTCGTGCGATGCATACCCT -> TCGTGCGATGCATACCCTA
GTCTAGGCCGCCTTTCCCG -> TCTAGGCCGCCTTTCCCGA
GTCTATCGCACCGAAAGGT -> TCTATCGCACCGAAAGGTG
GTCTATTGAGCGCTAAGGT -> TCTATTGAGCGCTAAGGTC
GTCTGACCGTCGAGACACT -> TCTGACCGTCGAGACACTG
GTCTTTGTAGAGGGACGAT -> TCTTTGTAGAGGGACGATC
GTGACGTGGTCAAGAACCG -> TGACGTGGTCAAGAACCGA
GTGACTATGGATTCGTAAT -> TGACTATGGATTCGTAATG
GTGAGGACTTTCCCCTTGG -> TGAGGACTTTCCCCTTGGC
GTGATGAAAAGGCCCCAAT -> TGATGAAAAGGCCCCAATC
GTGATTTGTTAATCGGCTG -> TGATTTGTTAATCGGCTGC
GTGCACACTCCGGTGATGA -> TGCACACTCCGGTGATGAA
GTGCATATCAAGTTCCTGC -> TGCATATCAAGTTCCTGCG
GTGCATCGCTAAACGTTGA -> TGCATCGCTAAACGTTGAG
GTGCATCGCTAAACTGGGA -> TGCATCGCTAAACTGGGAG
GTGCATCGCTAAGCGGAGT -> TGCATCGCTAAGCGGAGTT
GTGCATCGCTAATAAGTGT -> TGCATCGCTAATAAGTGTT
GTGCGATGCATACCCTAAC -> TGCGATGCATACCCTAACG
GTGCGCATTCTTGACCCCG -> TGCGCATTCTTGACCCCGC
GTGCTCGCCGCACGCCCTG -> TGCTCGCCGCACGCCCTGC
GTGCTCTCTGACATGTAAG -> TGCTCTCTGACATGTAAGT
GTGGACTATTCGCTAACCA -> TGGACTATTCGCTAACCAT
GTGGAGCCAAGACTTGGTG -> TGGAGCCAAGACTTGGTGC
GTGGATAAATGTAGATTCC -> TGGATAAATGTAGATTCCT
GTGGATGTCGCACACAGGT -> TGGATGTCGCACACAGGTG
GTGGGTTAGTAATCAGTCA -> TGGGTTAGTAATCAGTCAC
GTGGTCAAGAACCGAAAAG -> TGGTCAAGAACCGAAAAGA
GTGTAACTCTAGTGACTAT -> TGTAACTCTAGTGACTATG
GTGTACGTCACCGAGATCA -> TGTACGTCACCGAGATCAA
GTGTACTATTTGGATTTTT -> TGTACTATTTGGATTTTTG
GTGTAGGAGTCCTCAAATT -> TGTAGGAGTCCTCAAATTG
GTGTGAGGACTTTCCCCTT -> TGTGAGGACTTTCCCCTTG
GTGTGCATATCAAGTTCCT -> TGTGCATATCAAGTTCCTG
GTGTGCTCTCTGACATGTA -> TGTGCTCTCTGACATGTAA
GTGTTCAGGAGGCATCTGT -> TGTTCAGGAGGCATCTGTA
GTGTTTGGGACCACGTAAG -> TGTTTGGGACCACGTAAGC
GTTAATAGGTGATTTGTTA -> TTAATAGGTGATTTGTTAA
GTTAATCGGCTGCTCTGGG -> TTAATCGGCTGCTCTGGGG
GTTACGCTGACCTATATGC -> TTACGCTGACCTATATGCG
GTTAGTAATCAGTCACATT -> TTAGTAATCAGTCACATTA
GTTATAGCGCCATATTAGC -> TTATAGCGCCATATTAGCA
GTTATAGTAAGTCGGTCTA -> TTATAGTAAGTCGGTCTAT
GTTATCTGAACAATTAAGG -> TTATCTGAACAATTAAGGT
GTTATCTGAACACGGACTC -> TTATCTGAACACGGACTCC
GTTATCTGAACAGCGTACA -> TTATCTGAACAGCGTACAG
GTTATCTGAACATCGTGGA -> TTATCTGAACATCGTGGAG
GTTCAAACTGTTATCTGAA -> TTCAAACTGTTATCTGAAC
GTTCAAGGTGTGCTCTCTG -> TTCAAGGTGTGCTCTCTGA
GTTCACGCCAATACGATTT -> TTCACGCCAATACGATTTT
GTTCAGGAGGCATCTGTAC -> TTCAGGAGGCATCTGTACA
GTTCCAAGAATTAGCCATG -> TTCCAAGAATTAGCCATGG
GTTCCACAAACTGTTATCT -> TTCCACAAACTGTTATCTG
GTTCCCGGGTTTCTCGTGG -> TTCCCGGGTTTCTCGTGGA
GTTCCTGCGAAGGATTCTA -> TTCCTGCGAAGGATTCTAA
GTTCTAGACTTGGTGCATC -> TTCTAGACTTGGTGCATCG
GTTGAGTCGCTTATTGATT -> TTGAGTCGCTTATTGATTC
GTTGATTGCGGGATGGCAC -> TTGATTGCGGGATGGCACT
GTTGGACATCCCCCAGCGA -> TTGGACATCCCCCAGCGAG
GTTGTCGTACTATCATTGG -> TTGTCGTACTATCATTGGG
GTTTAACTTGATCTGACGC -> TTTAACTTGATCTGACGCT
GTTTATGGGCGGTCATTAC -> TTTATGGGCGGTCATTACC
GTTTCAGTATTGACCCAAC -> TTTCAGTATTGACCCAACT
GTTTCTCGTGGACTATTCG -> TTTCTCGTGGACTATTCGC
GTTTGGGACCACGTAAGCC -> TTTGGGACCACGTAAGCCG
TAAAAAAGTCACAAGGACA -> AAAAAAGTCACAAGGACAT
TAAAAGATGACCACGCTTA -> AAAAGATGACCACGCTTAC
TAAACAGGCGAGACGACCA -> AAACAGGCGAGACGACCAG
TAAACAGTCCCAGGGCCAC -> AAACAGTCCCAGGGCCACT
TAAACGTTGAGTCGCTTAT -> AAACGTTGAGTCGCTTATT
TAAACTGGGAGCGGCAGAT -> AAACTGGGAGCGGCAGATC
TAAATAATTTTGGCGGTAT -> AAATAATTTTGGCGGTATA
TAAATGTAGATTCCTTCTG -> AAATGTAGATTCCTTCTGT
TAACAGCGTTTATGGGCGG -> AACAGCGTTTATGGGCGGT
TAACAGGGTTCCAAGAATT -> AACAGGGTTCCAAGAATTA
TAACCACTCTGATAGTGTA -> AACCACTCTGATAGTGTAC
TAACCATAAACAGTCCCAG -> AACCATAAACAGTCCCAGG
TAACGCAAGCTAACTTTCA -> AACGCAAGCTAACTTTCAC
TAACGGAGCCTTAACGGTA -> AACGGAGCCTTAACGGTAG
TAACGGTAGTCCTTCGTTC -> AACGGTAGTCCTTCGTTCA
TAACGGTCATGAAGAGTAT -> AACGGTCATGAAGAGTATA
TAACTCTAGTGACTATGGA -> AACTCTAGTGACTATGGAT
TAACTGAGAGGACCTTCGC -> AACTGAGAGGACCTTCGCT
TAACTTGATCTGACGCTGC -> AACTTGATCTGACGCTGCT
TAACTTTCACGCGTTAATA -> AACTTTCACGCGTTAATAG
TAAGACCCAAATCTCACTG -> AAGACCCAAATCTCACTGG
TAAGACTTGGTGCATCGCT -> AAGACTTGGTGCATCGCTA
TAAGATCAGAATCAGAGCA -> AAGATCAGAATCAGAGCAA
TAAGCCGTACCCTGGACCA -> AAGCCGTACCCTGGACCAA
TAAGCGCAGCTTTTACCTT -> AAGCGCAGCTTTTACCTTG
TAAGCGGAGTTCCCGGGTT -> AAGCGGAGTTCCCGGGTTT
TAAGGATAGGGGGTAATTA -> AAGGATAGGGGGTAATTAA
TAAGGTCTAGGCCGCCTTT -> AAGGTCTAGGCCGCCTTTC
TAAGGTTCTAGACTTGGTG -> AAGGTTCTAGACTTGGTGC
TAAGTCATGGAGGCCAACA -> AAGTCATGGAGGCCAACAT
TAAGTCGGTCTATCGCACC -> AAGTCGGTCTATCGCACCG
TAAGTCTTTGTAGAGGGAC -> AAGTCTTTGTAGAGGGACG
TAAGTGCTCGCCGCACGCC -> AAGTGCTCGCCGCACGCCC
TAAGTGTTCAGGAGGCATC -> AAGTGTTCAGGAGGCATCT
TAATAAGTGTTCAGGAGGC -> AATAAGTGTTCAGGAGGCA
TAATAGGTGATTTGTTAAT -> AATAGGTGATTTGTTAATC
TAATCAGTCACATTACAGA -> AATCAGTCACATTACAGAT
TAATCCTTCCCAGGAGTCA -> AATCCTTCCCAGGAGTCAG
TAATCGGCTGCTCTGGGGC -> AATCGGCTGCTCTGGGGCG
TAATCTTCGCGATCTTAGT -> AATCTTCGCGATCTTAGTG
TAATGACACCATAATCTTC -> AATGACACCATAATCTTCG
TAATGGAAACAAGAAGACT -> AATGGAAACAAGAAGACTT
TAATTAACCACTCTGATAG -> AATTAACCACTCTGATAGT
TAATTTTGGCGGTATACGC -> AATTTTGGCGGTATACGCT
TACAAGCCTATGTCAATTC -> ACAAGCCTATGTCAATTCA
TACAGACGAGACTTGGTGC -> ACAGACGAGACTTGGTGCA
TACAGAGGCGAAGATGTCA -> ACAGAGGCGAAGATGTCAC
TACAGATTGCGGTAAGTGC -> ACAGATTGCGGTAAGTGCT
TACATCCCTATCGGCAGAT -> ACATCCCTATCGGCAGATC
TACCAGTCCGCCTTAGCGA -> ACCAGTCCGCCTTAGCGAT
TACCATCGTGCGCATTCTT -> ACCATCGTGCGCATTCTTG
TACCCTAACGCAAGCTAAC -> ACCCTAACGCAAGCTAACT
TACCCTGGACCAAGGCAAA -> ACCCTGGACCAAGGCAAAA
TACCCTTGGCAGACTCGTG -> ACCCTTGGCAGACTCGTGT
TACCTAAGGATAGGGGGTA -> ACCTAAGGATAGGGGGTAA
TACCTCAAAGACGATAAAT -> ACCTCAAAGACGATAAATA
TACCTTGCGGTGGGTTAGT -> ACCTTGCGGTGGGTTAGTA
TACGATTTTGCGAAAAGGC -> ACGATTTTGCGAAAAGGCG
TACGCCACAAGAACAGGGT -> ACGCCACAAGAACAGGGTA
TACGCCAGGAAGCTGTTGT -> ACGCCAGGAAGCTGTTGTC
TACGCTGACCTATATGCGA -> ACGCTGACCTATATGCGAT
TACGCTGCCGTAAAAAAGT -> ACGCTGCCGTAAAAAAGTC
TACGCTGGGTTCACGCCAA -> ACGCTGGGTTCACGCCAAT
TACGCTTCACTTGCGACAC -> ACGCTTCACTTGCGACACC
TACGGACGTCGTGCGATGC -> ACGGACGTCGTGCGATGCA
TACGGTCTATTGAGCGCTA -> ACGGTCTATTGAGCGCTAA
TACGTCACCGAGATCAAGG -> ACGTCACCGAGATCAAGGG
TACTACCTAAGGATAGGGG -> ACTACCTAAGGATAGGGGG
TACTATCATTGGGGAGACA -> ACTATCATTGGGGAGACAT
TACTATTTGGATTTTTGGG -> ACTATTTGGATTTTTGGGG
TACTTAGCACTCCAGACAG -> ACTTAGCACTCCAGACAGC
TAGACGTAGATACAAGCCT -> AGACGTAGATACAAGCCTA
TAGACTTGGTGCATCGCTA -> AGACTTGGTGCATCGCTAA
TAGAGGGACGATCTCGAAC -> AGAGGGACGATCTCGAACC
TAGATACAAGCCTATGTCA -> AGATACAAGCCTATGTCAA
TAGATCATGCGAACTCCAC -> AGATCATGCGAACTCCACA
TAGATCCTCGTAGGGGGGT -> AGATCCTCGTAGGGGGGTG
TAGATTCCTTCTGTGCACA -> AGATTCCTTCTGTGCACAC
TAGCAATTTTAAGATCAGA -> AGCAATTTTAAGATCAGAA
TAGCACTCCAGACAGCGCG -> AGCACTCCAGACAGCGCGC
TAGCATAACTGAGAGGACC -> AGCATAACTGAGAGGACCT
TAGCCATGGCGCCTACCCT -> AGCCATGGCGCCTACCCTT
TAGCGAGCGGATTAGACGT -> AGCGAGCGGATTAGACGTA
TAGCGATGCCTGGACTGGG -> AGCGATGCCTGGACTGGGT
TAGCGCCATATTAGCATAA -> AGCGCCATATTAGCATAAC
TAGCTACCTCAAAGACGAT -> AGCTACCTCAAAGACGATA
TAGGACTTGTAGTGTGAGG -> AGGACTTGTAGTGTGAGGA
TAGGAGTCCTCAAATTGCG -> AGGAGTCCTCAAATTGCGG
TAGGCCGCCTTTCCCGAGT -> AGGCCGCCTTTCCCGAGTA
TAGGGGGGTGTACGTCACC -> AGGGGGGTGTACGTCACCG
TAGGGGGTAATTAACCACT -> AGGGGGTAATTAACCACTC
TAGGTGATTTGTTAATCGG -> AGGTGATTTGTTAATCGGC
TAGGTTGATTGCGGGATGG -> AGGTTGATTGCGGGATGGC
TAGTAAGACCCAAATCTCA -> AGTAAGACCCAAATCTCAC
TAGTAAGTCGGTCTATCGC -> AGTAAGTCGGTCTATCGCA
TAGTAATCAGTCACATTAC -> AGTAATCAGTCACATTACA
TAGTCCTTCGTTCAAACTG -> AGTCCTTCGTTCAAACTGT
TAGTGACTATGGATTCGTA -> AGTGACTATGGATTCGTAA
TAGTGTACTATTTGGATTT -> AGTGTACTATTTGGATTTT
TAGTGTGAGGACTTTCCCC -> AGTGTGAGGACTTTCCCCT
TATAACAGCGTTTATGGGC -> ATAACAGCGTTTATGGGCG
TATACGCTGCCGTAAAAAA -> ATACGCTGCCGTAAAAAAG
TATACTTAGCACTCCAGAC -> ATACTTAGCACTCCAGACA
TATAGCGCCATATTAGCAT -> ATAGCGCCATATTAGCATA
TATAGCTACCTCAAAGACG -> ATAGCTACCTCAAAGACGA
TATAGTAAGTCGGTCTATC -> ATAGTAAGTCGGTCTATCG
TATATAGCTACCTCAAAGA -> ATATAGCTACCTCAAAGAC
TATATCCAGAGACGCACTT -> ATATCCAGAGACGCACTTA
TATATCTTGTGTTTGGGAC -> ATATCTTGTGTTTGGGACC
TATATGCGATTTGCCTCCG -> ATATGCGATTTGCCTCCGT
TATATTTATGTCAGCGATA -> ATATTTATGTCAGCGATAT
TATCAAGTTCCTGCGAAGG -> ATCAAGTTCCTGCGAAGGA
TATCATTGGGGAGACATAC -> ATCATTGGGGAGACATACG
TATCCAGAGACGCACTTAT -> ATCCAGAGACGCACTTATA
TATCGCACCGAAAGGTGGA -> ATCGCACCGAAAGGTGGAT
TATCGGCAGATCGGACTTC -> ATCGGCAGATCGGACTTCC
TATCTGAACAATTAAGGTT -> ATCTGAACAATTAAGGTTC
TATCTGAACACGGACTCCA -> ATCTGAACACGGACTCCAT
TATCTGAACAGCGTACAGA -> ATCTGAACAGCGTACAGAC
TATCTGAACATCGTGGAGC -> ATCTGAACATCGTGGAGCC
TATCTTGTGTTTGGGACCA -> ATCTTGTGTTTGGGACCAC
TATGCGATTTGCCTCCGTC -> ATGCGATTTGCCTCCGTCT
TATGGATTCGTAATGACAC -> ATGGATTCGTAATGACACC
TATGGGCGGTCATTACCAG -> ATGGGCGGTCATTACCAGT
TATGTACGCTGGGTTCACG -> ATGTACGCTGGGTTCACGC
TATGTCAATTCAGCCGGTT -> ATGTCAATTCAGCCGGTTA
TATGTCAGCGATATATCTT -> ATGTCAGCGATATATCTTG
TATTAATGGAAACAAGAAG -> ATTAATGGAAACAAGAAGA
TATTAGCATAACTGAGAGG -> ATTAGCATAACTGAGAGGA
TATTCGCTAACCATAAACA -> ATTCGCTAACCATAAACAG
TATTGACCCAACTAACAGG -> ATTGACCCAACTAACAGGG
TATTGAGCGCTAAGGTCTA -> ATTGAGCGCTAAGGTCTAG
TATTGAGGATTGGAGCACG -> ATTGAGGATTGGAGCACGT
TATTGATTCTTATGTACGC -> ATTGATTCTTATGTACGCT
TATTTATGTCAGCGATATA -> ATTTATGTCAGCGATATAT
TATTTGGATTTTTGGGGGT -> ATTTGGATTTTTGGGGGTA
TCAAACTGTTATCTGAACA -> CAAACTGTTATCTGAACAT
TCAAAGACGATAAATAATT -> CAAAGACGATAAATAATTT
TCAAATTGCGGCATCGACG -> CAAATTGCGGCATCGACGT
TCAAGAACCGAAAAGAATC -> CAAGAACCGAAAAGAATCC
TCAAGGGATCTGGGGGGCC -> CAAGGGATCTGGGGGGCCC
TCAAGGTGTGCTCTCTGAC -> CAAGGTGTGCTCTCTGACA
TCAAGTTCCTGCGAAGGAT -> CAAGTTCCTGCGAAGGATT
TCAATTCAGCCGGTTATAG -> CAATTCAGCCGGTTATAGC
TCACAAGGACATTCGGAGT -> CACAAGGACATTCGGAGTG
TCACATTACAGATTGCGGT -> CACATTACAGATTGCGGTA
TCACCAATAACGGTCATGA -> CACCAATAACGGTCATGAA
TCACCGAGATCAAGGGATC -> CACCGAGATCAAGGGATCT
TCACCTAGGTTGATTGCGG -> CACCTAGGTTGATTGCGGG
TCACGCCAATACGATTTTG -> CACGCCAATACGATTTTGC
TCACGCGTTAATAGGTGAT -> CACGCGTTAATAGGTGATT
TCACGGCCAAACTGTTATC -> CACGGCCAAACTGTTATCT
TCACTGGATACGCCAGGAA -> CACTGGATACGCCAGGAAG
TCACTTGCGACACCGGGTA -> CACTTGCGACACCGGGTAT
TCAGAATCAGAGCAACATT -> CAGAATCAGAGCAACATTG
TCAGAGCAACATTGAACGT -> CAGAGCAACATTGAACGTA
TCAGCACATGATTTCGGGG -> CAGCACATGATTTCGGGGA
TCAGCATAGGACTTGTAGT -> CAGCATAGGACTTGTAGTG
TCAGCCGGTTATAGCGCCA -> CAGCCGGTTATAGCGCCAT
TCAGCCTCATCTGGATACG -> CAGCCTCATCTGGATACGC
TCAGCGATATATCTTGTGT -> CAGCGATATATCTTGTGTT
TCAGGAGGCATCTGTACAT -> CAGGAGGCATCTGTACATC
TCAGGCTAAGTCTTTGTAG -> CAGGCTAAGTCTTTGTAGA
TCAGTATTGACCCAACTAA -> CAGTATTGACCCAACTAAC
TCAGTCACATTACAGATTG -> CAGTCACATTACAGATTGC
TCATCTGGATACGCCACAA -> CATCTGGATACGCCACAAG
TCATGAAGAGTATATCCAG -> CATGAAGAGTATATCCAGA
TCATGCGAACTCCACAACG -> CATGCGAACTCCACAACGC
TCATGGAGGCCAACATTGG -> CATGGAGGCCAACATTGGA
TCATTACCAGTCCGCCTTA -> CATTACCAGTCCGCCTTAG
TCATTGGGGAGACATACGG -> CATTGGGGAGACATACGGA
TCCAAGAATTAGCCATGGC -> CCAAGAATTAGCCATGGCG
TCCAAGATGCATGGCGACT -> CCAAGATGCATGGCGACTG
TCCACAAACTGTTATCTGA -> CCACAAACTGTTATCTGAA
TCCACAACGCGTCCCCAAG -> CCACAACGCGTCCCCAAGT
TCCAGACAGCGCGCTTCCG -> CCAGACAGCGCGCTTCCGT
TCCAGAGACGCACTTATAC -> CCAGAGACGCACTTATACT
TCCAGTTACGCTGACCTAT -> CCAGTTACGCTGACCTATA
TCCATAAGACTTGGTGCAT -> CCATAAGACTTGGTGCATC
TCCATCCTCCGTTATAGTA -> CCATCCTCCGTTATAGTAA
TCCATCGGAGGACTGGCTT -> CCATCGGAGGACTGGCTTG
TCCCAGGAGTCAGGCTAAG -> CCCAGGAGTCAGGCTAAGT
TCCCAGGGCCACTCGGGAC -> CCCAGGGCCACTCGGGACT
TCCCATCTGTTTAACTTGA -> CCCATCTGTTTAACTTGAT
TCCCCAAGTGTGCATATCA -> CCCCAAGTGTGCATATCAA
TCCCCCAGCGAGTAAGCGC -> CCCCCAGCGAGTAAGCGCA
TCCCCTTGGCCTTTAACGG -> CCCCTTGGCCTTTAACGGA
TCCCGAGTAAAAGATGACC -> CCCGAGTAAAAGATGACCA
TCCCGGGTTTCTCGTGGAC -> CCCGGGTTTCTCGTGGACT
TCCCTAGATCATGCGAACT -> CCCTAGATCATGCGAACTC
TCCCTATCGGCAGATCGGA -> CCCTATCGGCAGATCGGAC
TCCGAAGGCACGCTTTCTC -> CCGAAGGCACGCTTTCTCC
TCCGCCTTAGCGATGCCTG -> CCGCCTTAGCGATGCCTGG
TCCGGTGATGAAAAGGCCC -> CCGGTGATGAAAAGGCCCC
TCCGTCTGACCGTCGAGAC -> CCGTCTGACCGTCGAGACA
TCCGTTATAGTAAGTCGGT -> CCGTTATAGTAAGTCGGTC
TCCGTTTCAGTATTGACCC -> CCGTTTCAGTATTGACCCA
TCCTCAAATTGCGGCATCG -> CCTCAAATTGCGGCATCGA
TCCTCCGTTATAGTAAGTC -> CCTCCGTTATAGTAAGTCG
TCCTCGTAGGGGGGTGTAC -> CCTCGTAGGGGGGTGTACG
TCCTGCGAAGGATTCTAAA -> CCTGCGAAGGATTCTAAAC
TCCTTCCCAGGAGTCAGGC -> CCTTCCCAGGAGTCAGGCT
TCCTTCGTTCAAACTGTTA -> CCTTCGTTCAAACTGTTAT
TCCTTCTGTGCACACTCCG -> CCTTCTGTGCACACTCCGG
TCGAAATAGCAATTTTAAG -> CGAAATAGCAATTTTAAGA
TCGAACCTCCCATCTGTTT -> CGAACCTCCCATCTGTTTA
TCGACGTTGGACATCCCCC -> CGACGTTGGACATCCCCCA
TCGAGACACTGGTCACCAA -> CGAGACACTGGTCACCAAT
TCGCACACAGGTGACGTGG -> CGCACACAGGTGACGTGGT
TCGCACCGAAAGGTGGATG -> CGCACCGAAAGGTGGATGT
TCGCCAGCAAAATCTCAGC -> CGCCAGCAAAATCTCAGCA
TCGCCGCACGCCCTGCGAC -> CGCCGCACGCCCTGCGACT
TCGCGATCTTAGTGGCAGC -> CGCGATCTTAGTGGCAGCA
TCGCTAAACGTTGAGTCGC -> CGCTAAACGTTGAGTCGCT
TCGCTAAACTGGGAGCGGC -> CGCTAAACTGGGAGCGGCA
TCGCTAACCATAAACAGTC -> CGCTAACCATAAACAGTCC
TCGCTAAGCGGAGTTCCCG -> CGCTAAGCGGAGTTCCCGG
TCGCTAATAAGTGTTCAGG -> CGCTAATAAGTGTTCAGGA
TCGCTACCATCGTGCGCAT -> CGCTACCATCGTGCGCATT
TCGCTTATTGATTCTTATG -> CGCTTATTGATTCTTATGT
TCGCTTCTTCTGATATTGA -> CGCTTCTTCTGATATTGAG
TCGGACTTCCCTAGATCAT -> CGGACTTCCCTAGATCATG
TCGGAGGACTGGCTTGCGG -> CGGAGGACTGGCTTGCGGC
TCGGAGTGGATAAATGTAG -> CGGAGTGGATAAATGTAGA
TCGGCAGATCGGACTTCCC -> CGGCAGATCGGACTTCCCT
TCGGCGGACGCTGACACAA -> CGGCGGACGCTGACACAAT
TCGGCTGCTCTGGGGCGAA -> CGGCTGCTCTGGGGCGAAG
TCGGGACTCGTAGCGAGCG -> CGGGACTCGTAGCGAGCGG
TCGGGGATCCATCCTCCGT -> CGGGGATCCATCCTCCGTT
TCGGTCTATCGCACCGAAA -> CGGTCTATCGCACCGAAAG
TCGTAATGACACCATAATC -> CGTAATGACACCATAATCT
TCGTACTATCATTGGGGAG -> CGTACTATCATTGGGGAGA
TCGTAGCGAGCGGATTAGA -> CGTAGCGAGCGGATTAGAC
TCGTAGGGGGGTGTACGTC -> CGTAGGGGGGTGTACGTCA
TCGTATATTTATGTCAGCG -> CGTATATTTATGTCAGCGA
TCGTGCGATGCATACCCTA -> CGTGCGATGCATACCCTAA
TCGTGCGCATTCTTGACCC -> CGTGCGCATTCTTGACCCC
TCGTGGACTATTCGCTAAC -> CGTGGACTATTCGCTAACC
TCGTGGAGCCAAGACTTGG -> CGTGGAGCCAAGACTTGGT
TCGTGTAGGAGTCCTCAAA -> CGTGTAGGAGTCCTCAAAT
TCGTTCAAACTGTTATCTG -> CGTTCAAACTGTTATCTGA
TCTAAACAGGCGAGACGAC -> CTAAACAGGCGAGACGACC
TCTAGACTTGGTGCATCGC -> CTAGACTTGGTGCATCGCT
TCTAGGCCGCCTTTCCCGA -> CTAGGCCGCCTTTCCCGAG
TCTAGTGACTATGGATTCG -> CTAGTGACTATGGATTCGT
TCTATCGCACCGAAAGGTG -> CTATCGCACCGAAAGGTGG
TCTATTGAGCGCTAAGGTC -> CTATTGAGCGCTAAGGTCT
TCTCACTGGATACGCCAGG -> CTCACTGGATACGCCAGGA
TCTCAGCATAGGACTTGTA -> CTCAGCATAGGACTTGTAG
TCTCCATCGGAGGACTGGC -> CTCCATCGGAGGACTGGCT
TCTCCGAAGGCACGCTTTC -> CTCCGAAGGCACGCTTTCT
TCTCGAACCTCCCATCTGT -> CTCGAACCTCCCATCTGTT
TCTCGTGGACTATTCGCTA -> CTCGTGGACTATTCGCTAA
TCTCTCTGGGAATCAGCAC -> CTCTCTGGGAATCAGCACA
TCTCTGACATGTAAGTCAT -> CTCTGACATGTAAGTCATG
TCTCTGGGAATCAGCACAT -> CTCTGGGAATCAGCACATG
TCTGAACAATTAAGGTTCT -> CTGAACAATTAAGGTTCTA
TCTGAACACGGACTCCATA -> CTGAACACGGACTCCATAA
TCTGAACAGCGTACAGACG -> CTGAACAGCGTACAGACGA
TCTGAACATCGTGGAGCCA -> CTGAACATCGTGGAGCCAA
TCTGACATGTAAGTCATGG -> CTGACATGTAAGTCATGGA
TCTGACCGTCGAGACACTG -> CTGACCGTCGAGACACTGG
TCTGACGCTGCTGCCTATT -> CTGACGCTGCTGCCTATTA
TCTGATAGTGTACTATTTG -> CTGATAGTGTACTATTTGG
TCTGATATTGAGGATTGGA -> CTGATATTGAGGATTGGAG
TCTGGATACGCCACAAGAA -> CTGGATACGCCACAAGAAC
TCTGGGAATCAGCACATGA -> CTGGGAATCAGCACATGAT
TCTGGGGCGAAGAATCTCC -> CTGGGGCGAAGAATCTCCG
TCTGGGGGGCCCCTCTCTC -> CTGGGGGGCCCCTCTCTCT
TCTGTACATCCCTATCGGC -> CTGTACATCCCTATCGGCA
TCTGTGCACACTCCGGTGA -> CTGTGCACACTCCGGTGAT
TCTGTTTAACTTGATCTGA -> CTGTTTAACTTGATCTGAC
TCTTATGTACGCTGGGTTC -> CTTATGTACGCTGGGTTCA
TCTTCGCGATCTTAGTGGC -> CTTCGCGATCTTAGTGGCA
TCTTCTGATATTGAGGATT -> CTTCTGATATTGAGGATTG
TCTTGACCCCGCATAGTAA -> CTTGACCCCGCATAGTAAG
TCTTGTGTTTGGGACCACG -> CTTGTGTTTGGGACCACGT
TCTTTGTAGAGGGACGATC -> CTTTGTAGAGGGACGATCT
TGAAAAGGCCCCAATCGAA -> GAAAAGGCCCCAATCGAAA
TGAACAATTAAGGTTCTAG -> GAACAATTAAGGTTCTAGA
TGAACACGGACTCCATAAG -> GAACACGGACTCCATAAGA
TGAACAGCGTACAGACGAG -> GAACAGCGTACAGACGAGA
TGAACATCGTGGAGCCAAG -> GAACATCGTGGAGCCAAGA
TGAACGTACAGAGGCGAAG -> GAACGTACAGAGGCGAAGA
TGAAGAGTATATCCAGAGA -> GAAGAGTATATCCAGAGAC
TGACACAATGATCAGCCTC -> GACACAATGATCAGCCTCA
TGACACCATAATCTTCGCG -> GACACCATAATCTTCGCGA
TGACATGTAAGTCATGGAG -> GACATGTAAGTCATGGAGG
TGACCACGCTTACGCTTCA -> GACCACGCTTACGCTTCAC
TGACCCAACTAACAGGGTT -> GACCCAACTAACAGGGTTC
TGACCCCGCATAGTAAGAC -> GACCCCGCATAGTAAGACC
TGACCGTCGAGACACTGGT -> GACCGTCGAGACACTGGTC
TGACCTATATGCGATTTGC -> GACCTATATGCGATTTGCC
TGACGCTGCTGCCTATTAA -> GACGCTGCTGCCTATTAAT
TGACGTGGTCAAGAACCGA -> GACGTGGTCAAGAACCGAA
TGACTATGGATTCGTAATG -> GACTATGGATTCGTAATGA
TGAGAGGACCTTCGCTTCT -> GAGAGGACCTTCGCTTCTT
TGAGCGCTAAGGTCTAGGC -> GAGCGCTAAGGTCTAGGCC
TGAGGACTTTCCCCTTGGC -> GAGGACTTTCCCCTTGGCC
TGAGGATTGGAGCACGTAT -> GAGGATTGGAGCACGTATA
TGAGTCGCTTATTGATTCT -> GAGTCGCTTATTGATTCTT
TGATAGTGTACTATTTGGA -> GATAGTGTACTATTTGGAT
TGATATTGAGGATTGGAGC -> GATATTGAGGATTGGAGCA
TGATCAGCCTCATCTGGAT -> GATCAGCCTCATCTGGATA
TGATCTGACGCTGCTGCCT -> GATCTGACGCTGCTGCCTA
TGATGAAAAGGCCCCAATC -> GATGAAAAGGCCCCAATCG
TGATGTGTAACTCTAGTGA -> GATGTGTAACTCTAGTGAC
TGATTCTTATGTACGCTGG -> GATTCTTATGTACGCTGGG
TGATTGCGGGATGGCACTC -> GATTGCGGGATGGCACTCG
TGATTTCGGGGATCCATCC -> GATTTCGGGGATCCATCCT
TGATTTGTTAATCGGCTGC -> GATTTGTTAATCGGCTGCT
TGCACACTCCGGTGATGAA -> GCACACTCCGGTGATGAAA
TGCATACCCTAACGCAAGC -> GCATACCCTAACGCAAGCT
TGCATATCAAGTTCCTGCG -> GCATATCAAGTTCCTGCGA
TGCATCGCTAAACGTTGAG -> GCATCGCTAAACGTTGAGT
TGCATCGCTAAACTGGGAG -> GCATCGCTAAACTGGGAGC
TGCATCGCTAAGCGGAGTT -> GCATCGCTAAGCGGAGTTC
TGCATCGCTAATAAGTGTT -> GCATCGCTAATAAGTGTTC
TGCATGGCGACTGATGTGT -> GCATGGCGACTGATGTGTA
TGCCGTAAAAAAGTCACAA -> GCCGTAAAAAAGTCACAAG
TGCCTATTAATGGAAACAA -> GCCTATTAATGGAAACAAG
TGCCTCCGTCTGACCGTCG -> GCCTCCGTCTGACCGTCGA
TGCCTGGACTGGGTTCAAG -> GCCTGGACTGGGTTCAAGG
TGCGAAAAGGCGATCGTAT -> GCGAAAAGGCGATCGTATA
TGCGAACTCCACAACGCGT -> GCGAACTCCACAACGCGTC
TGCGAAGGATTCTAAACAG -> GCGAAGGATTCTAAACAGG
TGCGACACCGGGTATATAG -> GCGACACCGGGTATATAGC
TGCGACTCACCTAGGTTGA -> GCGACTCACCTAGGTTGAT
TGCGATGCATACCCTAACG -> GCGATGCATACCCTAACGC
TGCGATTTGCCTCCGTCTG -> GCGATTTGCCTCCGTCTGA
TGCGCATTCTTGACCCCGC -> GCGCATTCTTGACCCCGCA
TGCGGCAAACTGTTATCTG -> GCGGCAAACTGTTATCTGA
TGCGGCATCGACGTTGGAC -> GCGGCATCGACGTTGGACA
TGCGGGATGGCACTCGCCA -> GCGGGATGGCACTCGCCAG
TGCGGTAAGTGCTCGCCGC -> GCGGTAAGTGCTCGCCGCA
TGCGGTGGGTTAGTAATCA -> GCGGTGGGTTAGTAATCAG
TGCTCGCCGCACGCCCTGC -> GCTCGCCGCACGCCCTGCG
TGCTCTCTGACATGTAAGT -> GCTCTCTGACATGTAAGTC
TGCTCTGGGGCGAAGAATC -> GCTCTGGGGCGAAGAATCT
TGCTGCCTATTAATGGAAA -> GCTGCCTATTAATGGAAAC
TGGAAACAAGAAGACTTTC -> GGAAACAAGAAGACTTTCG
TGGACATCCCCCAGCGAGT -> GGACATCCCCCAGCGAGTA
TGGACCAAGGCAAAATACT -> GGACCAAGGCAAAATACTA
TGGACTATTCGCTAACCAT -> GGACTATTCGCTAACCATA
TGGACTGGGTTCAAGGTGT -> GGACTGGGTTCAAGGTGTG
TGGAGCACGTATAACAGCG -> GGAGCACGTATAACAGCGT
TGGAGCCAAGACTTGGTGC -> GGAGCCAAGACTTGGTGCA
TGGAGGCCAACATTGGATA -> GGAGGCCAACATTGGATAA
TGGATAAATGTAGATTCCT -> GGATAAATGTAGATTCCTT
TGGATAATCCTTCCCAGGA -> GGATAATCCTTCCCAGGAG
TGGATACGCCACAAGAACA -> GGATACGCCACAAGAACAG
TGGATACGCCAGGAAGCTG -> GGATACGCCAGGAAGCTGT
TGGATGTCGCACACAGGTG -> GGATGTCGCACACAGGTGA
TGGATTCGTAATGACACCA -> GGATTCGTAATGACACCAT
TGGATTTTTGGGGGTACGG -> GGATTTTTGGGGGTACGGT
TGGCACTCGCCAGCAAAAT -> GGCACTCGCCAGCAAAATC
TGGCAGACTCGTGTAGGAG -> GGCAGACTCGTGTAGGAGT
TGGCCTTTAACGGAGCCTT -> GGCCTTTAACGGAGCCTTA
TGGCGACTGATGTGTAACT -> GGCGACTGATGTGTAACTC
TGGCGCCTACCCTTGGCAG -> GGCGCCTACCCTTGGCAGA
TGGCGGTATACGCTGCCGT -> GGCGGTATACGCTGCCGTA
TGGCTTGCGGCAAACTGTT -> GGCTTGCGGCAAACTGTTA
TGGGAATCAGCACATGATT -> GGGAATCAGCACATGATTT
TGGGACCACGTAAGCCGTA -> GGGACCACGTAAGCCGTAC
TGGGAGCGGCAGATCGGCG -> GGGAGCGGCAGATCGGCGG
TGGGCGGTCATTACCAGTC -> GGGCGGTCATTACCAGTCC
TGGGGAGACATACGGACGT -> GGGGAGACATACGGACGTC
TGGGGCGAAGAATCTCCGA -> GGGGCGAAGAATCTCCGAA
TGGGGGGCCCCTCTCTCTG -> GGGGGGCCCCTCTCTCTGG
TGGGGGTACGGTCTATTGA -> GGGGGTACGGTCTATTGAG
TGGGTTAGTAATCAGTCAC -> GGGTTAGTAATCAGTCACA
TGGGTTCAAGGTGTGCTCT -> GGGTTCAAGGTGTGCTCTC
TGGGTTCACGCCAATACGA -> GGGTTCACGCCAATACGAT
TGGTCAAGAACCGAAAAGA -> GGTCAAGAACCGAAAAGAA
TGGTCACCAATAACGGTCA -> GGTCACCAATAACGGTCAT
TGGTGCATCGCTAAACGTT -> GGTGCATCGCTAAACGTTG
TGGTGCATCGCTAAACTGG -> GGTGCATCGCTAAACTGGG
TGGTGCATCGCTAAGCGGA -> GGTGCATCGCTAAGCGGAG
TGGTGCATCGCTAATAAGT -> GGTGCATCGCTAATAAGTG
TGTAACTCTAGTGACTATG -> GTAACTCTAGTGACTATGG
TGTAAGTCATGGAGGCCAA -> GTAAGTCATGGAGGCCAAC
TGTACATCCCTATCGGCAG -> GTACATCCCTATCGGCAGA
TGTACGCTGGGTTCACGCC -> GTACGCTGGGTTCACGCCA
TGTACGTCACCGAGATCAA -> GTACGTCACCGAGATCAAG
TGTACTATTTGGATTTTTG -> GTACTATTTGGATTTTTGG
TGTAGAGGGACGATCTCGA -> GTAGAGGGACGATCTCGAA
TGTAGATTCCTTCTGTGCA -> GTAGATTCCTTCTGTGCAC
TGTAGGAGTCCTCAAATTG -> GTAGGAGTCCTCAAATTGC
TGTAGTGTGAGGACTTTCC -> GTAGTGTGAGGACTTTCCC
TGTCAATTCAGCCGGTTAT -> GTCAATTCAGCCGGTTATA
TGTCACGGCCAAACTGTTA -> GTCACGGCCAAACTGTTAT
TGTCAGCGATATATCTTGT -> GTCAGCGATATATCTTGTG
TGTCGCACACAGGTGACGT -> GTCGCACACAGGTGACGTG
TGTCGTACTATCATTGGGG -> GTCGTACTATCATTGGGGA
TGTGAGGACTTTCCCCTTG -> GTGAGGACTTTCCCCTTGG
TGTGCACACTCCGGTGATG -> GTGCACACTCCGGTGATGA
TGTGCATATCAAGTTCCTG -> GTGCATATCAAGTTCCTGC
TGTGCTCTCTGACATGTAA -> GTGCTCTCTGACATGTAAG
TGTGTAACTCTAGTGACTA -> GTGTAACTCTAGTGACTAT
TGTGTTTGGGACCACGTAA -> GTGTTTGGGACCACGTAAG
TGTTAATCGGCTGCTCTGG -> GTTAATCGGCTGCTCTGGG
TGTTATCTGAACAATTAAG -> GTTATCTGAACAATTAAGG
TGTTATCTGAACACGGACT -> GTTATCTGAACACGGACTC
TGTTATCTGAACAGCGTAC -> GTTATCTGAACAGCGTACA
TGTTATCTGAACATCGTGG -> GTTATCTGAACATCGTGGA
TGTTCAGGAGGCATCTGTA -> GTTCAGGAGGCATCTGTAC
TGTTGTCGTACTATCATTG -> GTTGTCGTACTATCATTGG
TGTTTAACTTGATCTGACG -> GTTTAACTTGATCTGACGC
TGTTTGGGACCACGTAAGC -> GTTTGGGACCACGTAAGCC
TTAACCACTCTGATAGTGT -> TAACCACTCTGATAGTGTA
TTAACGGAGCCTTAACGGT -> TAACGGAGCCTTAACGGTA
TTAACGGTAGTCCTTCGTT -> TAACGGTAGTCCTTCGTTC
TTAACTTGATCTGACGCTG -> TAACTTGATCTGACGCTGC
TTAAGATCAGAATCAGAGC -> TAAGATCAGAATCAGAGCA
TTAAGGTTCTAGACTTGGT -> TAAGGTTCTAGACTTGGTG
TTAATAGGTGATTTGTTAA -> TAATAGGTGATTTGTTAAT
TTAATCGGCTGCTCTGGGG -> TAATCGGCTGCTCTGGGGC
TTAATGGAAACAAGAAGAC -> TAATGGAAACAAGAAGACT
TTACAGATTGCGGTAAGTG -> TACAGATTGCGGTAAGTGC
TTACCAGTCCGCCTTAGCG -> TACCAGTCCGCCTTAGCGA
TTACCTTGCGGTGGGTTAG -> TACCTTGCGGTGGGTTAGT
TTACGCTGACCTATATGCG -> TACGCTGACCTATATGCGA
TTACGCTTCACTTGCGACA -> TACGCTTCACTTGCGACAC
TTAGACGTAGATACAAGCC -> TAGACGTAGATACAAGCCT
TTAGCACTCCAGACAGCGC -> TAGCACTCCAGACAGCGCG
TTAGCATAACTGAGAGGAC -> TAGCATAACTGAGAGGACC
TTAGCCATGGCGCCTACCC -> TAGCCATGGCGCCTACCCT
TTAGCGATGCCTGGACTGG -> TAGCGATGCCTGGACTGGG
TTAGTAATCAGTCACATTA -> TAGTAATCAGTCACATTAC
TTATACTTAGCACTCCAGA -> TATACTTAGCACTCCAGAC
TTATAGCGCCATATTAGCA -> TATAGCGCCATATTAGCAT
TTATAGTAAGTCGGTCTAT -> TATAGTAAGTCGGTCTATC
TTATCTGAACAATTAAGGT -> TATCTGAACAATTAAGGTT
TTATCTGAACACGGACTCC -> TATCTGAACACGGACTCCA
TTATCTGAACAGCGTACAG -> TATCTGAACAGCGTACAGA
TTATCTGAACATCGTGGAG -> TATCTGAACATCGTGGAGC
TTATGGGCGGTCATTACCA -> TATGGGCGGTCATTACCAG
TTATGTACGCTGGGTTCAC -> TATGTACGCTGGGTTCACG
TTATGTCAGCGATATATCT -> TATGTCAGCGATATATCTT
TTATTGATTCTTATGTACG -> TATTGATTCTTATGTACGC
TTCAAACTGTTATCTGAAC -> TCAAACTGTTATCTGAACA
TTCAAGGTGTGCTCTCTGA -> TCAAGGTGTGCTCTCTGAC
TTCACGCCAATACGATTTT -> TCACGCCAATACGATTTTG
TTCACGCGTTAATAGGTGA -> TCACGCGTTAATAGGTGAT
TTCACTTGCGACACCGGGT -> TCACTTGCGACACCGGGTA
TTCAGCCGGTTATAGCGCC -> TCAGCCGGTTATAGCGCCA
TTCAGGAGGCATCTGTACA -> TCAGGAGGCATCTGTACAT
TTCAGTATTGACCCAACTA -> TCAGTATTGACCCAACTAA
TTCCAAGAATTAGCCATGG -> TCCAAGAATTAGCCATGGC
TTCCACAAACTGTTATCTG -> TCCACAAACTGTTATCTGA
TTCCCAGGAGTCAGGCTAA -> TCCCAGGAGTCAGGCTAAG
TTCCCCTTGGCCTTTAACG -> TCCCCTTGGCCTTTAACGG
TTCCCGAGTAAAAGATGAC -> TCCCGAGTAAAAGATGACC
TTCCCGGGTTTCTCGTGGA -> TCCCGGGTTTCTCGTGGAC
TTCCCTAGATCATGCGAAC -> TCCCTAGATCATGCGAACT
TTCCGTTTCAGTATTGACC -> TCCGTTTCAGTATTGACCC
TTCCTGCGAAGGATTCTAA -> TCCTGCGAAGGATTCTAAA
TTCCTTCTGTGCACACTCC -> TCCTTCTGTGCACACTCCG
TTCGCGATCTTAGTGGCAG -> TCGCGATCTTAGTGGCAGC
TTCGCTAACCATAAACAGT -> TCGCTAACCATAAACAGTC
TTCGCTACCATCGTGCGCA -> TCGCTACCATCGTGCGCAT
TTCGCTTCTTCTGATATTG -> TCGCTTCTTCTGATATTGA
TTCGGAGTGGATAAATGTA -> TCGGAGTGGATAAATGTAG
TTCGGGGATCCATCCTCCG -> TCGGGGATCCATCCTCCGT
TTCGTAATGACACCATAAT -> TCGTAATGACACCATAATC
TTCGTTCAAACTGTTATCT -> TCGTTCAAACTGTTATCTG
TTCTAAACAGGCGAGACGA -> TCTAAACAGGCGAGACGAC
TTCTAGACTTGGTGCATCG -> TCTAGACTTGGTGCATCGC
TTCTCCATCGGAGGACTGG -> TCTCCATCGGAGGACTGGC
TTCTCGTGGACTATTCGCT -> TCTCGTGGACTATTCGCTA
TTCTGATATTGAGGATTGG -> TCTGATATTGAGGATTGGA
TTCTGTGCACACTCCGGTG -> TCTGTGCACACTCCGGTGA
TTCTTATGTACGCTGGGTT -> TCTTATGTACGCTGGGTTC
TTCTTCTGATATTGAGGAT -> TCTTCTGATATTGAGGATT
TTCTTGACCCCGCATAGTA -> TCTTGACCCCGCATAGTAA
TTGAACGTACAGAGGCGAA -> TGAACGTACAGAGGCGAAG
TTGACCCAACTAACAGGGT -> TGACCCAACTAACAGGGTT
TTGACCCCGCATAGTAAGA -> TGACCCCGCATAGTAAGAC
TTGAGCGCTAAGGTCTAGG -> TGAGCGCTAAGGTCTAGGC
TTGAGGATTGGAGCACGTA -> TGAGGATTGGAGCACGTAT
TTGAGTCGCTTATTGATTC -> TGAGTCGCTTATTGATTCT
TTGATCTGACGCTGCTGCC -> TGATCTGACGCTGCTGCCT
TTGATTCTTATGTACGCTG -> TGATTCTTATGTACGCTGG
TTGATTGCGGGATGGCACT -> TGATTGCGGGATGGCACTC
TTGCCTCCGTCTGACCGTC -> TGCCTCCGTCTGACCGTCG
TTGCGAAAAGGCGATCGTA -> TGCGAAAAGGCGATCGTAT
TTGCGACACCGGGTATATA -> TGCGACACCGGGTATATAG
TTGCGGCAAACTGTTATCT -> TGCGGCAAACTGTTATCTG
TTGCGGCATCGACGTTGGA -> TGCGGCATCGACGTTGGAC
TTGCGGGATGGCACTCGCC -> TGCGGGATGGCACTCGCCA
TTGCGGTAAGTGCTCGCCG -> TGCGGTAAGTGCTCGCCGC
TTGCGGTGGGTTAGTAATC -> TGCGGTGGGTTAGTAATCA
TTGGACATCCCCCAGCGAG -> TGGACATCCCCCAGCGAGT
TTGGAGCACGTATAACAGC -> TGGAGCACGTATAACAGCG
TTGGATAATCCTTCCCAGG -> TGGATAATCCTTCCCAGGA
TTGGATTTTTGGGGGTACG -> TGGATTTTTGGGGGTACGG
TTGGCAGACTCGTGTAGGA -> TGGCAGACTCGTGTAGGAG
TTGGCCTTTAACGGAGCCT -> TGGCCTTTAACGGAGCCTT
TTGGCGGTATACGCTGCCG -> TGGCGGTATACGCTGCCGT
TTGGGACCACGTAAGCCGT -> TGGGACCACGTAAGCCGTA
TTGGGGAGACATACGGACG -> TGGGGAGACATACGGACGT
TTGGGGGTACGGTCTATTG -> TGGGGGTACGGTCTATTGA
TTGGTGCATCGCTAAACGT -> TGGTGCATCGCTAAACGTT
TTGGTGCATCGCTAAACTG -> TGGTGCATCGCTAAACTGG
TTGGTGCATCGCTAAGCGG -> TGGTGCATCGCTAAGCGGA
TTGGTGCATCGCTAATAAG -> TGGTGCATCGCTAATAAGT
TTGTAGAGGGACGATCTCG -> TGTAGAGGGACGATCTCGA
TTGTAGTGTGAGGACTTTC -> TGTAGTGTGAGGACTTTCC
TTGTCGTACTATCATTGGG -> TGTCGTACTATCATTGGGG
TTGTGTTTGGGACCACGTA -> TGTGTTTGGGACCACGTAA
TTGTTAATCGGCTGCTCTG -> TGTTAATCGGCTGCTCTGG
TTTAACGGAGCCTTAACGG -> TTAACGGAGCCTTAACGGT
TTTAACTTGATCTGACGCT -> TTAACTTGATCTGACGCTG
TTTAAGATCAGAATCAGAG -> TTAAGATCAGAATCAGAGC
TTTACCTTGCGGTGGGTTA -> TTACCTTGCGGTGGGTTAG
TTTATGGGCGGTCATTACC -> TTATGGGCGGTCATTACCA
TTTATGTCAGCGATATATC -> TTATGTCAGCGATATATCT
TTTCACGCGTTAATAGGTG -> TTCACGCGTTAATAGGTGA
TTTCAGTATTGACCCAACT -> TTCAGTATTGACCCAACTA
TTTCCCCTTGGCCTTTAAC -> TTCCCCTTGGCCTTTAACG
TTTCCCGAGTAAAAGATGA -> TTCCCGAGTAAAAGATGAC
TTTCGCTACCATCGTGCGC -> TTCGCTACCATCGTGCGCA
TTTCGGGGATCCATCCTCC -> TTCGGGGATCCATCCTCCG
TTTCTCCATCGGAGGACTG -> TTCTCCATCGGAGGACTGG
TTTCTCGTGGACTATTCGC -> TTCTCGTGGACTATTCGCT
TTTGCCTCCGTCTGACCGT -> TTGCCTCCGTCTGACCGTC
TTTGCGAAAAGGCGATCGT -> TTGCGAAAAGGCGATCGTA
TTTGGATTTTTGGGGGTAC -> TTGGATTTTTGGGGGTACG
TTTGGCGGTATACGCTGCC -> TTGGCGGTATACGCTGCCG
TTTGGGACCACGTAAGCCG -> TTGGGACCACGTAAGCCGT
TTTGGGGGTACGGTCTATT -> TTGGGGGTACGGTCTATTG
TTTGTAGAGGGACGATCTC -> TTGTAGAGGGACGATCTCG
TTTGTTAATCGGCTGCTCT -> TTGTTAATCGGCTGCTCTG
TTTTAAGATCAGAATCAGA -> TTTAAGATCAGAATCAGAG
TTTTACCTTGCGGTGGGTT -> TTTACCTTGCGGTGGGTTA
TTTTGCGAAAAGGCGATCG -> TTTGCGAAAAGGCGATCGT
TTTTGGCGGTATACGCTGC -> TTTGGCGGTATACGCTGCC
TTTTGGGGGTACGGTCTAT -> TTTGGGGGTACGGTCTATT
TTTTTGGGGGTACGGTCTA -> TTTTGGGGGTACGGTCTAT
