AAAAACAATCA -> AAAACAATCAA
AAAAAGTACGC -> AAAAGTACGCT
AAAACAATCAA -> AAACAATCAAC
AAAACGAGAGG -> AAACGAGAGGG
AAAACGGGGCC -> AAACGGGGCCG
AAAAGCCCGGA -> AAAGCCCGGAC
AAAAGTACGCT -> AAAGTACGCTA
AAACAATCAAC -> AACAATCAACC
AAACACGCGCA -> AACACGCGCAA
AAACCTGGTTT -> AACCTGGTTTA
AAACGAGAGGG -> AACGAGAGGGA
AAACGCGAGCT -> AACGCGAGCTA
AAACGGCCTTC -> AACGGCCTTCT
AAACGGGGCCG -> AACGGGGCCGA
AAACGGTGGAT -> AACGGTGGATG
AAACGTAAAGA -> AACGTAAAGAG
AAACGTTGTGA -> AACGTTGTGAG
AAACTAACTTC -> AACTAACTTCT
AAAGAGTTCGA -> AAGAGTTCGAG
AAAGCCCGGAC -> AAGCCCGGACC
AAAGCTACCGA -> AAGCTACCGAC
AAAGGACATGT -> AAGGACATGTC
AAAGTAAGACC -> AAGTAAGACCG
AAAGTACGCTA -> AAGTACGCTAA
AAATAAATTCA -> AATAAATTCAC
AAATCGCTCGT -> AATCGCTCGTG
AAATGATTAGG -> AATGATTAGGT
AAATTATCGAC -> AATTATCGACG
AAATTCACGAA -> AATTCACGAAC
AACAATCAACC -> ACAATCAACCG
AACACGCGCAA -> ACACGCGCAAT
AACACTCGTGT -> ACACTCGTGTA
AACAGACCCGT -> ACAGACCCGTC
AACAGCTCCAC -> ACAGCTCCACT
AACAGTGACGA -> ACAGTGACGAC
AACATACCATT -> ACATACCATTC
AACCAATTTAA -> ACCAATTTAAC
AACCACCACAG -> ACCACCACAGG
AACCCGGGACG -> ACCCGGGACGT
AACCCTGGGCG -> ACCCTGGGCGC
AACCGACTTTT -> ACCGACTTTTA
AACCTGGTTTA -> ACCTGGTTTAC
AACGACAGAGG -> ACGACAGAGGC
AACGACCGATT -> ACGACCGATTT
AACGAGAGGGA -> ACGAGAGGGAT
AACGCGAGCTA -> ACGCGAGCTAC
AACGCGCAGCT -> ACGCGCAGCTA
AACGGCCTTCT -> ACGGCCTTCTT
AACGGGATTCA -> ACGGGATTCAC
AACGGGGCCGA -> ACGGGGCCGAC
AACGGTGGATG -> ACGGTGGATGA
AACGTAAAGAG -> ACGTAAAGAGT
AACGTCCTCAG -> ACGTCCTCAGA
AACGTGACCGC -> ACGTGACCGCG
AACGTGCTAGA -> ACGTGCTAGAA
AACGTTGTCCA -> ACGTTGTCCAA
AACGTTGTGAG -> ACGTTGTGAGT
AACTAACTTCT -> ACTAACTTCTG
AACTCGGCTCG -> ACTCGGCTCGG
AACTCTCGGAG -> ACTCTCGGAGC
AACTGTAGTCA -> ACTGTAGTCAG
AACTTCTGGTA -> ACTTCTGGTAC
AACTTTTGACC -> ACTTTTGACCT
AAGAAAAAGTA -> AGAAAAAGTAC
AAGAACGCGCA -> AGAACGCGCAG
AAGACCGCGCT -> AGACCGCGCTG
AAGAGTTCGAG -> AGAGTTCGAGC
AAGATGGTAAA -> AGATGGTAAAA
AAGCAGTTAGG -> AGCAGTTAGGC
AAGCCCGGACC -> AGCCCGGACCA
AAGCGGATCAC -> AGCGGATCACA
AAGCTACCGAC -> AGCTACCGACA
AAGCTGATGCT -> AGCTGATGCTG
AAGCTTATATG -> AGCTTATATGT
AAGGACAACCA -> AGGACAACCAC
AAGGACAAGGA -> AGGACAAGGAC
AAGGACATGTC -> AGGACATGTCT
AAGGAGCGACT -> AGGAGCGACTA
AAGGCTCAGCC -> AGGCTCAGCCA
AAGGGCGGTAA -> AGGGCGGTAAA
AAGGGGCCTAG -> AGGGGCCTAGC
AAGTAAGACCG -> AGTAAGACCGC
AAGTACGCTAA -> AGTACGCTAAT
AAGTCTACCCG -> AGTCTACCCGA
AAGTGGACTTG -> AGTGGACTTGC
AAGTGTACCTT -> AGTGTACCTTG
AAGTTGGCCCG -> AGTTGGCCCGT
AATAAATTCAC -> ATAAATTCACG
AATAACAGACC -> ATAACAGACCC
AATAACTTTTG -> ATAACTTTTGA
AATAATGTCAG -> ATAATGTCAGT
AATAGACCACG -> ATAGACCACGC
AATAGACTTAT -> ATAGACTTATT
AATATCGCCTA -> ATATCGCCTAG
AATCAACCGAC -> ATCAACCGACT
AATCATATGAT -> ATCATATGATC
AATCCCAACAA -> ATCCCAACAAG
AATCCCCAATG -> ATCCCCAATGC
AATCCGCTATA -> ATCCGCTATAT
AATCCTTAGTT -> ATCCTTAGTTT
AATCGCTCGTG -> ATCGCTCGTGC
AATGACAATAA -> ATGACAATAAT
AATGAGGTAAC -> ATGAGGTAACG
AATGATCCCTC -> ATGATCCCTCC
AATGATTAGGT -> ATGATTAGGTC
AATGCACAGTA -> ATGCACAGTAT
AATGCTGAAAT -> ATGCTGAAATC
AATGTCAGTAT -> ATGTCAGTATT
AATGTCAGTGT -> ATGTCAGTGTC
AATGTCCCGAG -> ATGTCCCGAGA
AATGTGCCGAG -> ATGTGCCGAGA
AATGTGTGCTA -> ATGTGTGCTAA
AATTATAAGCT -> ATTATAAGCTG
AATTATCGACG -> ATTATCGACGC
AATTCACGAAC -> ATTCACGAACT
AATTCGACTTT -> ATTCGACTTTT
AATTCTGGGAA -> ATTCTGGGAAA
AATTGTTTATC -> ATTGTTTATCA
AATTTAACGTC -> ATTTAACGTCC
AATTTATTGTC -> ATTTATTGTCG
ACAAATGATTA -> CAAATGATTAG
ACAACCACCAC -> CAACCACCACA
ACAACGACCGA -> CAACGACCGAT
ACAACTCTCGG -> CAACTCTCGGA
ACAAGGACAAC -> CAAGGACAACC
ACAAGTTGGCC -> CAAGTTGGCCC
ACAATAATGTC -> CAATAATGTCA
ACAATCAACCG -> CAATCAACCGA
ACAATCCCAAC -> CAATCCCAACA
ACAATGAGGTA -> CAATGAGGTAA
ACACGCCCTCC -> CACGCCCTCCG
ACACGCGCAAT -> CACGCGCAATG
ACACGGCCATT -> CACGGCCATTG
ACACTCGAACA -> CACTCGAACAC
ACACTCGACAA -> CACTCGACAAT
ACACTCGTGTA -> CACTCGTGTAG
ACACTGTGAAA -> CACTGTGAAAC
ACACTTACACG -> CACTTACACGC
ACAGACCCGTC -> CAGACCCGTCC
ACAGAGGCACG -> CAGAGGCACGA
ACAGAGGCTTT -> CAGAGGCTTTG
ACAGAGGGTGA -> CAGAGGGTGAC
ACAGAGGTCCA -> CAGAGGTCCAT
ACAGCTCCACT -> CAGCTCCACTC
ACAGGTGAGGA -> CAGGTGAGGAC
ACAGTATAAGA -> CAGTATAAGAT
ACAGTGACGAC -> CAGTGACGACC
ACATACCATTC -> CATACCATTCT
ACATATACCAT -> CATATACCATA
ACATCCCCACG -> CATCCCCACGT
ACATGAAGGCT -> CATGAAGGCTC
ACATGCTATGA -> CATGCTATGAC
ACATGTCTGTT -> CATGTCTGTTA
ACCAACCAATT -> CCAACCAATTT
ACCAAGAACGC -> CCAAGAACGCG
ACCAAGCAGTT -> CCAAGCAGTTA
ACCAATTTAAC -> CCAATTTAACG
ACCACAGGTGA -> CCACAGGTGAG
ACCACCACAGG -> CCACCACAGGT
ACCACGCTACC -> CCACGCTACCA
ACCACGGATTG -> CCACGGATTGC
ACCAGCAAGTC -> CCAGCAAGTCT
ACCATAGTCTA -> CCATAGTCTAC
ACCATCCTTTC -> CCATCCTTTCG
ACCATCGGGCA -> CCATCGGGCAG
ACCATTCTCGT -> CCATTCTCGTT
ACCCAGAGTGG -> CCCAGAGTGGA
ACCCAGCAGAA -> CCCAGCAGAAT
ACCCATATCCG -> CCCATATCCGT
ACCCATTGTCG -> CCCATTGTCGA
ACCCGATGAGC -> CCCGATGAGCC
ACCCGGGACGT -> CCCGGGACGTG
ACCCGGGCAAT -> CCCGGGCAATT
ACCCGGTTACT -> CCCGGTTACTC
ACCCGTCCCCC -> CCCGTCCCCCA
ACCCTGGAACT -> CCCTGGAACTG
ACCCTGGGCGC -> CCCTGGGCGCC
ACCGACAGAGG -> CCGACAGAGGT
ACCGACTTTTA -> CCGACTTTTAA
ACCGATTTTAC -> CCGATTTTACA
ACCGCGCTGAA -> CCGCGCTGAAT
ACCGCGGGGAG -> CCGCGGGGAGC
ACCGCTACTTA -> CCGCTACTTAA
ACCGGCCTCGG -> CCGGCCTCGGT
ACCGGTACCTC -> CCGGTACCTCC
ACCGGTGTGTG -> CCGGTGTGTGC
ACCTCCCGCGA -> CCTCCCGCGAA
ACCTCCGATTG -> CCTCCGATTGC
ACCTCTAACAT -> CCTCTAACATA
ACCTGGTTTAC -> CCTGGTTTACC
ACCTGTGTGAA -> CCTGTGTGAAC
ACCTTCTCTAG -> CCTTCTCTAGA
ACCTTGGACCA -> CCTTGGACCAT
ACGAACTCGGC -> CGAACTCGGCT
ACGACAGAGGC -> CGACAGAGGCT
ACGACCACGGA -> CGACCACGGAT
ACGACCGATTT -> CGACCGATTTT
ACGAGAAGTGT -> CGAGAAGTGTA
ACGAGACGCGC -> CGAGACGCGCA
ACGAGAGGGAT -> CGAGAGGGATT
ACGAGATATCC -> CGAGATATCCC
ACGATTCTGTC -> CGATTCTGTCA
ACGCCCTCCGA -> CGCCCTCCGAC
ACGCGAGCTAC -> CGCGAGCTACG
ACGCGCAATGT -> CGCGCAATGTC
ACGCGCAGACT -> CGCGCAGACTC
ACGCGCAGCTA -> CGCGCAGCTAA
ACGCTAATGCT -> CGCTAATGCTG
ACGCTACCAAG -> CGCTACCAAGC
ACGCTGAGGGA -> CGCTGAGGGAT
ACGCTTATCGA -> CGCTTATCGAC
ACGGATTGCTT -> CGGATTGCTTA
ACGGCACAATC -> CGGCACAATCC
ACGGCAGGGGT -> CGGCAGGGGTG
ACGGCCATTGG -> CGGCCATTGGG
ACGGCCTTCTT -> CGGCCTTCTTA
ACGGGATTCAC -> CGGGATTCACC
ACGGGGCCGAC -> CGGGGCCGACA
ACGGTGGATGA -> CGGTGGATGAT
ACGGTTAGGAG -> CGGTTAGGAGC
ACGTAAAGAGT -> CGTAAAGAGTT
ACGTCCTATGA -> CGTCCTATGAC
ACGTCCTCAGA -> CGTCCTCAGAT
ACGTCGGCTAC -> CGTCGGCTACG
ACGTGACCGCG -> CGTGACCGCGG
ACGTGCCAACG -> CGTGCCAACGT
ACGTGCTAGAA -> CGTGCTAGAAA
ACGTGGGTCGT -> CGTGGGTCGTC
ACGTGTTTTTA -> CGTGTTTTTAT
ACGTTGTCCAA -> CGTTGTCCAAT
ACGTTGTGAGT -> CGTTGTGAGTA
ACTAACAGCTC -> CTAACAGCTCC
ACTAACTTCTG -> CTAACTTCTGG
ACTAGTTACTC -> CTAGTTACTCC
ACTCATCTATT -> CTCATCTATTA
ACTCATGAAGA -> CTCATGAAGAA
ACTCCAGAATC -> CTCCAGAATCC
ACTCCAGACTA -> CTCCAGACTAA
ACTCCAGTCAC -> CTCCAGTCACA
ACTCCCATTCG -> CTCCCATTCGG
ACTCCGGCATT -> CTCCGGCATTG
ACTCGAACACT -> CTCGAACACTC
ACTCGAATTGT -> CTCGAATTGTT
ACTCGACAATG -> CTCGACAATGA
ACTCGGCTCGG -> CTCGGCTCGGC
ACTCGTCATGG -> CTCGTCATGGT
ACTCGTGTAGA -> CTCGTGTAGAC
ACTCTCATTTG -> CTCTCATTTGT
ACTCTCGGAGC -> CTCTCGGAGCT
ACTCTGAGACA -> CTCTGAGACAT
ACTGACTGCCT -> CTGACTGCCTT
ACTGCCTTATT -> CTGCCTTATTT
ACTGGATAATG -> CTGGATAATGA
ACTGGCATAGA -> CTGGCATAGAG
ACTGTAGTCAG -> CTGTAGTCAGT
ACTGTGAAACG -> CTGTGAAACGC
ACTTAATAACT -> CTTAATAACTT
ACTTACACGCC -> CTTACACGCCC
ACTTATTAATC -> CTTATTAATCA
ACTTCTGGTAC -> CTTCTGGTACA
ACTTGCCCTTG -> CTTGCCCTTGT
ACTTTTAAAGT -> CTTTTAAAGTA
ACTTTTCCTGT -> CTTTTCCTGTA
ACTTTTGACCT -> CTTTTGACCTG
AGAAAAAGTAC -> GAAAAAGTACG
AGAAATTATCG -> GAAATTATCGA
AGAACAGTGAC -> GAACAGTGACG
AGAACGCGCAG -> GAACGCGCAGC
AGAAGTGGACT -> GAAGTGGACTT
AGAAGTGTACC -> GAAGTGTACCT
AGAATCCCCAA -> GAATCCCCAAT
AGAATCCTTAG -> GAATCCTTAGT
AGAATTCTGGG -> GAATTCTGGGA
AGACACTGTGA -> GACACTGTGAA
AGACATGCTAT -> GACATGCTATG
AGACCACGCTA -> GACCACGCTAC
AGACCCGTCCC -> GACCCGTCCCC
AGACCGCGCTG -> GACCGCGCTGA
AGACGCGCAGA -> GACGCGCAGAC
AGACTAACAGC -> GACTAACAGCT
AGACTCCGGCA -> GACTCCGGCAT
AGACTTATTAA -> GACTTATTAAT
AGAGAAGTGGA -> GAGAAGTGGAC
AGAGAATCCCC -> GAGAATCCCCA
AGAGGCACGAG -> GAGGCACGAGA
AGAGGCTTTGG -> GAGGCTTTGGG
AGAGGGATTTG -> GAGGGATTTGT
AGAGGGTGACC -> GAGGGTGACCT
AGAGGTCCATG -> GAGGTCCATGT
AGAGTGAAACG -> GAGTGAAACGT
AGAGTGGATTA -> GAGTGGATTAA
AGAGTTAATGA -> GAGTTAATGAC
AGAGTTCGAGC -> GAGTTCGAGCG
AGATACAACGA -> GATACAACGAC
AGATATCCCGC -> GATATCCCGCT
AGATCCATCCC -> GATCCATCCCA
AGATGAATGTC -> GATGAATGTCC
AGATGGTAAAA -> GATGGTAAAAC
AGATTACTGGA -> GATTACTGGAT
AGCAAGTCTAC -> GCAAGTCTACC
AGCAGAATTCT -> GCAGAATTCTG
AGCAGGGGTTA -> GCAGGGGTTAC
AGCAGTAAAAA -> GCAGTAAAAAC
AGCAGTTAGGC -> GCAGTTAGGCT
AGCCAAGGGCG -> GCCAAGGGCGG
AGCCCGGACCA -> GCCCGGACCAT
AGCCTCCGTAC -> GCCTCCGTACA
AGCCTCTTGGT -> GCCTCTTGGTC
AGCGACTAGTT -> GCGACTAGTTA
AGCGCCTCGAA -> GCGCCTCGAAC
AGCGCGGAAGG -> GCGCGGAAGGG
AGCGGATCACA -> GCGGATCACAG
AGCTAAACGGC -> GCTAAACGGCC
AGCTAATAACA -> GCTAATAACAG
AGCTACCGACA -> GCTACCGACAG
AGCTACGTGCC -> GCTACGTGCCA
AGCTAGATTAC -> GCTAGATTACT
AGCTATTCGCC -> GCTATTCGCCC
AGCTCCACTCC -> GCTCCACTCCA
AGCTGATGCTG -> GCTGATGCTGA
AGCTGCCCCGC -> GCTGCCCCGCA
AGCTTATATGT -> GCTTATATGTT
AGGACAACCAC -> GGACAACCACC
AGGACAAGGAC -> GGACAAGGACA
AGGACACTTAC -> GGACACTTACA
AGGACATGTCT -> GGACATGTCTG
AGGAGCAGTAA -> GGAGCAGTAAA
AGGAGCGACTA -> GGAGCGACTAG
AGGAGGTGACT -> GGAGGTGACTC
AGGCACGAGAT -> GGCACGAGATA
AGGCTCAGCCA -> GGCTCAGCCAA
AGGCTGCGCGA -> GGCTGCGCGAG
AGGCTGGGACG -> GGCTGGGACGA
AGGCTTTCGGG -> GGCTTTCGGGA
AGGCTTTGGGG -> GGCTTTGGGGC
AGGGATGGGCC -> GGGATGGGCCC
AGGGATTTGTA -> GGGATTTGTAT
AGGGCGGTAAA -> GGGCGGTAAAC
AGGGCTACGTG -> GGGCTACGTGT
AGGGGCCTAGC -> GGGGCCTAGCT
AGGGGTGAAAT -> GGGGTGAAATA
AGGGGTTACTG -> GGGGTTACTGA
AGGGTGACCTC -> GGGTGACCTCT
AGGTAACGTGA -> GGTAACGTGAC
AGGTCCATGTT -> GGTCCATGTTT
AGGTCGATCTA -> GGTCGATCTAT
AGGTGACTCAT -> GGTGACTCATG
AGGTGAGGACA -> GGTGAGGACAC
AGGTGTTGCTC -> GGTGTTGCTCA
AGTAAAAACAA -> GTAAAAACAAT
AGTAAGACCGC -> GTAAGACCGCG
AGTACGCTAAT -> GTACGCTAATG
AGTACGGTTAG -> GTACGGTTAGG
AGTATAAGATG -> GTATAAGATGG
AGTATTAGAAC -> GTATTAGAACA
AGTCACATGAA -> GTCACATGAAG
AGTCAGTTGCC -> GTCAGTTGCCT
AGTCCGATGAG -> GTCCGATGAGG
AGTCTACATCC -> GTCTACATCCC
AGTCTACCCGA -> GTCTACCCGAT
AGTGAAACGTA -> GTGAAACGTAA
AGTGACGACCA -> GTGACGACCAC
AGTGGACTTGC -> GTGGACTTGCC
AGTGGATTAAA -> GTGGATTAAAC
AGTGGCCTCAA -> GTGGCCTCAAT
AGTGTACCTTG -> GTGTACCTTGG
AGTGTCTACCC -> GTGTCTACCCG
AGTTAATGACA -> GTTAATGACAA
AGTTACTCCAG -> GTTACTCCAGA
AGTTAGGCTTT -> GTTAGGCTTTC
AGTTCCAGATG -> GTTCCAGATGA
AGTTCGAGCGC -> GTTCGAGCGCG
AGTTGCCTGGT -> GTTGCCTGGTG
AGTTGGCCCGT -> GTTGGCCCGTT
AGTTTTCCCAC -> GTTTTCCCACC
ATAAATTCACG -> TAAATTCACGA
ATAACAGACCC -> TAACAGACCCG
ATAACTTTTGA -> TAACTTTTGAC
ATAAGATGGTA -> TAAGATGGTAA
ATAAGCTGATG -> TAAGCTGATGC
ATAATGATCCC -> TAATGATCCCT
ATAATGTCAGT -> TAATGTCAGTA
ATACAACGACC -> TACAACGACCG
ATACCATAGTC -> TACCATAGTCT
ATACCATTCTC -> TACCATTCTCG
ATAGACCACGC -> TAGACCACGCT
ATAGACTTATT -> TAGACTTATTA
ATAGAGTTAAT -> TAGAGTTAATG
ATAGTCTACAT -> TAGTCTACATC
ATATACCATAG -> TATACCATAGT
ATATCCAGGAG -> TATCCAGGAGG
ATATCCCGCTC -> TATCCCGCTCC
ATATCCGTAGT -> TATCCGTAGTT
ATATCCTGGCT -> TATCCTGGCTA
ATATCGCCTAG -> TATCGCCTAGG
ATATGATCACT -> TATGATCACTC
ATATGCTGACG -> TATGCTGACGG
ATATGTTGAAA -> TATGTTGAAAG
ATCAAAGGACA -> TCAAAGGACAT
ATCAACCGACT -> TCAACCGACTT
ATCACAGAGGC -> TCACAGAGGCA
ATCACCGCTAC -> TCACCGCTACT
ATCACTCGTCA -> TCACTCGTCAT
ATCATATGATC -> TCATATGATCA
ATCCAGGAGGT -> TCCAGGAGGTG
ATCCATCCCAC -> TCCATCCCACT
ATCCCAACAAG -> TCCCAACAAGG
ATCCCACTCTC -> TCCCACTCTCA
ATCCCCAATGC -> TCCCCAATGCA
ATCCCCACGTC -> TCCCCACGTCC
ATCCCGCTCCA -> TCCCGCTCCAC
ATCCCTCCCAC -> TCCCTCCCACG
ATCCGCTATAT -> TCCGCTATATG
ATCCGTAGTTC -> TCCGTAGTTCC
ATCCTGGCTAG -> TCCTGGCTAGC
ATCCTTAGTTT -> TCCTTAGTTTT
ATCCTTTCGAA -> TCCTTTCGAAC
ATCGACACGGC -> TCGACACGGCC
ATCGACGCTGA -> TCGACGCTGAG
ATCGCCTAGGC -> TCGCCTAGGCT
ATCGCTCGTGC -> TCGCTCGTGCC
ATCGGGCAGCA -> TCGGGCAGCAG
ATCGTCCTACT -> TCGTCCTACTC
ATCTATGCCCC -> TCTATGCCCCC
ATCTATTATTA -> TCTATTATTAT
ATCTATTGCCA -> TCTATTGCCAC
ATGAAGAAAAA -> TGAAGAAAAAG
ATGAAGGCTCA -> TGAAGGCTCAG
ATGAATGTCCC -> TGAATGTCCCG
ATGAATGTGCC -> TGAATGTGCCG
ATGACAATAAT -> TGACAATAATG
ATGACCAACCA -> TGACCAACCAA
ATGACCCAGCA -> TGACCCAGCAG
ATGACCCATTG -> TGACCCATTGT
ATGAGCCTCCG -> TGAGCCTCCGT
ATGAGGTAACG -> TGAGGTAACGT
ATGAGGTGTTG -> TGAGGTGTTGC
ATGATATCCTG -> TGATATCCTGG
ATGATCACTCG -> TGATCACTCGT
ATGATCCCTCC -> TGATCCCTCCC
ATGATTAGGTC -> TGATTAGGTCG
ATGATTGCAAT -> TGATTGCAATC
ATGCACAGTAT -> TGCACAGTATA
ATGCCCCCCGG -> TGCCCCCCGGT
ATGCTATGACC -> TGCTATGACCA
ATGCTGAAATC -> TGCTGAAATCG
ATGCTGACGGC -> TGCTGACGGCA
ATGCTGATGAC -> TGCTGATGACC
ATGGCCACTGG -> TGGCCACTGGC
ATGGGCCCCTT -> TGGGCCCCTTT
ATGGTAAAACG -> TGGTAAAACGA
ATGGTGAATAT -> TGGTGAATATC
ATGGTGTTCCT -> TGGTGTTCCTG
ATGTCAGTATT -> TGTCAGTATTA
ATGTCAGTGTC -> TGTCAGTGTCT
ATGTCCCGAGA -> TGTCCCGAGAG
ATGTCTGTTAT -> TGTCTGTTATC
ATGTGCCGAGA -> TGTGCCGAGAG
ATGTGTGCTAA -> TGTGTGCTAAT
ATGTTGAAAGC -> TGTTGAAAGCT
ATGTTTAGTGG -> TGTTTAGTGGC
ATTAAACTAAC -> TTAAACTAACT
ATTAATCATAT -> TTAATCATATG
ATTACTGGATA -> TTACTGGATAA
ATTAGAACAGT -> TTAGAACAGTG
ATTAGGTCGAT -> TTAGGTCGATC
ATTATAAGCTG -> TTATAAGCTGA
ATTATCACCGC -> TTATCACCGCT
ATTATCGACGC -> TTATCGACGCT
ATTATTATCAC -> TTATTATCACC
ATTCACCGGTA -> TTCACCGGTAC
ATTCACGAACT -> TTCACGAACTC
ATTCCGCAGGC -> TTCCGCAGGCT
ATTCGACAACT -> TTCGACAACTC
ATTCGACTTTT -> TTCGACTTTTC
ATTCGCCCAGC -> TTCGCCCAGCT
ATTCGGTAATA -> TTCGGTAATAG
ATTCTCGTTAA -> TTCTCGTTAAA
ATTCTGGGAAA -> TTCTGGGAAAC
ATTCTGTCAAG -> TTCTGTCAAGG
ATTGCAATCCG -> TTGCAATCCGC
ATTGCCACCCT -> TTGCCACCCTG
ATTGCCGTTTC -> TTGCCGTTTCT
ATTGCTGATTC -> TTGCTGATTCC
ATTGCTTAAAC -> TTGCTTAAACC
ATTGGGTTAGA -> TTGGGTTAGAT
ATTGTCGACAC -> TTGTCGACACT
ATTGTCGCCAT -> TTGTCGCCATG
ATTGTTTATCA -> TTGTTTATCAA
ATTGTTTTTGC -> TTGTTTTTGCT
ATTTAACGTCC -> TTTAACGTCCT
ATTTACTCCAG -> TTTACTCCAGA
ATTTATTGTCG -> TTTATTGTCGC
ATTTCAAGCGG -> TTTCAAGCGGA
ATTTGTATTCG -> TTTGTATTCGA
ATTTGTTTAAA -> TTTGTTTAAAC
ATTTTACAGAG -> TTTTACAGAGG
CAAAGGACATG -> AAAGGACATGT
CAAATGATTAG -> AAATGATTAGG
CAACCAATTTA -> AACCAATTTAA
CAACCACCACA -> AACCACCACAG
CAACCGACTTT -> AACCGACTTTT
CAACGACCGAT -> AACGACCGATT
CAACGTGCTAG -> AACGTGCTAGA
CAACTCTCGGA -> AACTCTCGGAG
CAAGAACGCGC -> AAGAACGCGCA
CAAGCAGTTAG -> AAGCAGTTAGG
CAAGCGGATCA -> AAGCGGATCAC
CAAGGACAACC -> AAGGACAACCA
CAAGGACAAGG -> AAGGACAAGGA
CAAGGAGCGAC -> AAGGAGCGACT
CAAGGGCGGTA -> AAGGGCGGTAA
CAAGTCTACCC -> AAGTCTACCCG
CAAGTTGGCCC -> AAGTTGGCCCG
CAATAATGTCA -> AATAATGTCAG
CAATAGACTTA -> AATAGACTTAT
CAATCAACCGA -> AATCAACCGAC
CAATCCCAACA -> AATCCCAACAA
CAATCCGCTAT -> AATCCGCTATA
CAATGAGGTAA -> AATGAGGTAAC
CAATGCACAGT -> AATGCACAGTA
CAATGTCAGTG -> AATGTCAGTGT
CAATTATAAGC -> AATTATAAGCT
CAATTTAACGT -> AATTTAACGTC
CAATTTATTGT -> AATTTATTGTC
CACAAGTTGGC -> ACAAGTTGGCC
CACAATCCCAA -> ACAATCCCAAC
CACAGAGGCAC -> ACAGAGGCACG
CACAGGTGAGG -> ACAGGTGAGGA
CACAGTATAAG -> ACAGTATAAGA
CACATGAAGGC -> ACATGAAGGCT
CACCACAGGTG -> ACCACAGGTGA
CACCAGCAAGT -> ACCAGCAAGTC
CACCCAGAGTG -> ACCCAGAGTGG
CACCCGGGCAA -> ACCCGGGCAAT
CACCCTGGAAC -> ACCCTGGAACT
CACCGCTACTT -> ACCGCTACTTA
CACCGGTACCT -> ACCGGTACCTC
CACCTCCGATT -> ACCTCCGATTG
CACCTTCTCTA -> ACCTTCTCTAG
CACGAACTCGG -> ACGAACTCGGC
CACGAGATATC -> ACGAGATATCC
CACGATTCTGT -> ACGATTCTGTC
CACGCCCTCCG -> ACGCCCTCCGA
CACGCGCAATG -> ACGCGCAATGT
CACGCTACCAA -> ACGCTACCAAG
CACGGATTGCT -> ACGGATTGCTT
CACGGCCATTG -> ACGGCCATTGG
CACGTCCTATG -> ACGTCCTATGA
CACTCCAGTCA -> ACTCCAGTCAC
CACTCGAACAC -> ACTCGAACACT
CACTCGAATTG -> ACTCGAATTGT
CACTCGACAAT -> ACTCGACAATG
CACTCGTCATG -> ACTCGTCATGG
CACTCGTGTAG -> ACTCGTGTAGA
CACTCTCATTT -> ACTCTCATTTG
CACTGGCATAG -> ACTGGCATAGA
CACTGTGAAAC -> ACTGTGAAACG
CACTTACACGC -> ACTTACACGCC
CAGAATCCTTA -> AGAATCCTTAG
CAGAATTCTGG -> AGAATTCTGGG
CAGACCCGTCC -> AGACCCGTCCC
CAGACTAACAG -> AGACTAACAGC
CAGACTCCGGC -> AGACTCCGGCA
CAGAGGCACGA -> AGAGGCACGAG
CAGAGGCTTTG -> AGAGGCTTTGG
CAGAGGGTGAC -> AGAGGGTGACC
CAGAGGTCCAT -> AGAGGTCCATG
CAGAGTGGATT -> AGAGTGGATTA
CAGATACAACG -> AGATACAACGA
CAGATGAATGT -> AGATGAATGTC
CAGCAAGTCTA -> AGCAAGTCTAC
CAGCAGAATTC -> AGCAGAATTCT
CAGCAGGGGTT -> AGCAGGGGTTA
CAGCCAAGGGC -> AGCCAAGGGCG
CAGCTAAACGG -> AGCTAAACGGC
CAGCTAGATTA -> AGCTAGATTAC
CAGCTCCACTC -> AGCTCCACTCC
CAGGAGGTGAC -> AGGAGGTGACT
CAGGCTGCGCG -> AGGCTGCGCGA
CAGGGCTACGT -> AGGGCTACGTG
CAGGGGTGAAA -> AGGGGTGAAAT
CAGGGGTTACT -> AGGGGTTACTG
CAGGTGAGGAC -> AGGTGAGGACA
CAGTAAAAACA -> AGTAAAAACAA
CAGTATAAGAT -> AGTATAAGATG
CAGTATTAGAA -> AGTATTAGAAC
CAGTCACATGA -> AGTCACATGAA
CAGTGACGACC -> AGTGACGACCA
CAGTGTCTACC -> AGTGTCTACCC
CAGTTAGGCTT -> AGTTAGGCTTT
CAGTTGCCTGG -> AGTTGCCTGGT
CATACCATTCT -> ATACCATTCTC
CATAGAGTTAA -> ATAGAGTTAAT
CATAGTCTACA -> ATAGTCTACAT
CATATACCATA -> ATATACCATAG
CATATCCGTAG -> ATATCCGTAGT
CATATGATCAC -> ATATGATCACT
CATCCCACTCT -> ATCCCACTCTC
CATCCCCACGT -> ATCCCCACGTC
CATCCTTTCGA -> ATCCTTTCGAA
CATCGGGCAGC -> ATCGGGCAGCA
CATCTATGCCC -> ATCTATGCCCC
CATCTATTATT -> ATCTATTATTA
CATGAAGAAAA -> ATGAAGAAAAA
CATGAAGGCTC -> ATGAAGGCTCA
CATGCTATGAC -> ATGCTATGACC
CATGGCCACTG -> ATGGCCACTGG
CATGGTGAATA -> ATGGTGAATAT
CATGGTGTTCC -> ATGGTGTTCCT
CATGTCTGTTA -> ATGTCTGTTAT
CATGTTTAGTG -> ATGTTTAGTGG
CATTCGGTAAT -> ATTCGGTAATA
CATTCTCGTTA -> ATTCTCGTTAA
CATTGGGTTAG -> ATTGGGTTAGA
CATTGTCGACA -> ATTGTCGACAC
CATTGTTTTTG -> ATTGTTTTTGC
CATTTCAAGCG -> ATTTCAAGCGG
CATTTGTTTAA -> ATTTGTTTAAA
CCAACCAATTT -> CAACCAATTTA
CCAACGTGCTA -> CAACGTGCTAG
CCAAGAACGCG -> CAAGAACGCGC
CCAAGCAGTTA -> CAAGCAGTTAG
CCAAGGACAAG -> CAAGGACAAGG
CCAAGGGCGGT -> CAAGGGCGGTA
CCAATAGACTT -> CAATAGACTTA
CCAATGCACAG -> CAATGCACAGT
CCAATTTAACG -> CAATTTAACGT
CCACAAGTTGG -> CACAAGTTGGC
CCACAGGTGAG -> CACAGGTGAGG
CCACCACAGGT -> CACCACAGGTG
CCACCCGGGCA -> CACCCGGGCAA
CCACCCTGGAA -> CACCCTGGAAC
CCACGATTCTG -> CACGATTCTGT
CCACGCTACCA -> CACGCTACCAA
CCACGGATTGC -> CACGGATTGCT
CCACGTCCTAT -> CACGTCCTATG
CCACTCCAGTC -> CACTCCAGTCA
CCACTCTCATT -> CACTCTCATTT
CCACTGGCATA -> CACTGGCATAG
CCAGAATCCTT -> CAGAATCCTTA
CCAGACTAACA -> CAGACTAACAG
CCAGAGTGGAT -> CAGAGTGGATT
CCAGATGAATG -> CAGATGAATGT
CCAGCAAGTCT -> CAGCAAGTCTA
CCAGCAGAATT -> CAGCAGAATTC
CCAGCTAGATT -> CAGCTAGATTA
CCAGGAGGTGA -> CAGGAGGTGAC
CCAGTCACATG -> CAGTCACATGA
CCATAGTCTAC -> CATAGTCTACA
CCATATCCGTA -> CATATCCGTAG
CCATCCCACTC -> CATCCCACTCT
CCATCCTTTCG -> CATCCTTTCGA
CCATCGGGCAG -> CATCGGGCAGC
CCATGGCCACT -> CATGGCCACTG
CCATGTTTAGT -> CATGTTTAGTG
CCATTCGGTAA -> CATTCGGTAAT
CCATTCTCGTT -> CATTCTCGTTA
CCATTGGGTTA -> CATTGGGTTAG
CCATTGTCGAC -> CATTGTCGACA
CCATTTCAAGC -> CATTTCAAGCG
CCCAAGGACAA -> CCAAGGACAAG
CCCAATGCACA -> CCAATGCACAG
CCCACCCGGGC -> CCACCCGGGCA
CCCACGATTCT -> CCACGATTCTG
CCCACGTCCTA -> CCACGTCCTAT
CCCACTCTCAT -> CCACTCTCATT
CCCAGAGTGGA -> CCAGAGTGGAT
CCCAGCAGAAT -> CCAGCAGAATT
CCCAGCTAGAT -> CCAGCTAGATT
CCCATATCCGT -> CCATATCCGTA
CCCATTCGGTA -> CCATTCGGTAA
CCCATTGTCGA -> CCATTGTCGAC
CCCCAAGGACA -> CCCAAGGACAA
CCCCAATGCAC -> CCCAATGCACA
CCCCACGTCCT -> CCCACGTCCTA
CCCCCAAGGAC -> CCCCAAGGACA
CCCCCCGGTAA -> CCCCCGGTAAA
CCCCCGGTAAA -> CCCCGGTAAAA
CCCCGACTCCC -> CCCGACTCCCA
CCCCGCACCAG -> CCCGCACCAGC
CCCCGGTAAAA -> CCCGGTAAAAG
CCCCTTTTCGG -> CCCTTTTCGGA
CCCGACTCCCA -> CCGACTCCCAT
CCCGAGAGAAG -> CCGAGAGAAGT
CCCGATGAGCC -> CCGATGAGCCT
CCCGCACCAGC -> CCGCACCAGCA
CCCGCGAAGCT -> CCGCGAAGCTT
CCCGCTCCACA -> CCGCTCCACAA
CCCGGACCATC -> CCGGACCATCC
CCCGGGACGTG -> CCGGGACGTGG
CCCGGGCAATT -> CCGGGCAATTT
CCCGGTAAAAG -> CCGGTAAAAGC
CCCGGTTACTC -> CCGGTTACTCT
CCCGTCCCCCA -> CCGTCCCCCAA
CCCGTTTACGA -> CCGTTTACGAG
CCCTCCCACGA -> CCTCCCACGAT
CCCTCCGACGT -> CCTCCGACGTC
CCCTGGAACTG -> CCTGGAACTGT
CCCTGGGCGCC -> CCTGGGCGCCT
CCCTTGTCACC -> CCTTGTCACCC
CCCTTTTCGGA -> CCTTTTCGGAA
CCGACAGAGGT -> CGACAGAGGTC
CCGACATATAC -> CGACATATACC
CCGACGTCGGC -> CGACGTCGGCT
CCGACTCCCAT -> CGACTCCCATT
CCGACTTTTAA -> CGACTTTTAAA
CCGAGAGAAGT -> CGAGAGAAGTG
CCGAGAGTGAA -> CGAGAGTGAAA
CCGATGAGCCT -> CGATGAGCCTC
CCGATGAGGTG -> CGATGAGGTGT
CCGATTGCCGT -> CGATTGCCGTT
CCGATTTTACA -> CGATTTTACAG
CCGCACCAGCA -> CGCACCAGCAA
CCGCAGGCTGC -> CGCAGGCTGCG
CCGCCGGGATA -> CGCCGGGATAT
CCGCGAAGCTT -> CGCGAAGCTTA
CCGCGCTGAAT -> CGCGCTGAATG
CCGCGGGGAGC -> CGCGGGGAGCT
CCGCTACTTAA -> CGCTACTTAAT
CCGCTATATGC -> CGCTATATGCT
CCGCTCCACAA -> CGCTCCACAAG
CCGGACCATCC -> CGGACCATCCT
CCGGCATTGTT -> CGGCATTGTTT
CCGGCCTCGGT -> CGGCCTCGGTG
CCGGGACGTGG -> CGGGACGTGGG
CCGGGATATCC -> CGGGATATCCA
CCGGGCAATTT -> CGGGCAATTTA
CCGGTAAAAGC -> CGGTAAAAGCC
CCGGTACCTCC -> CGGTACCTCCC
CCGGTGTGTGC -> CGGTGTGTGCA
CCGGTTACTCT -> CGGTTACTCTG
CCGTACAAATG -> CGTACAAATGA
CCGTAGTTCCA -> CGTAGTTCCAG
CCGTCCCCCAA -> CGTCCCCCAAG
CCGTGATTGCT -> CGTGATTGCTG
CCGTTTACGAG -> CGTTTACGAGA
CCGTTTCTACG -> CGTTTCTACGC
CCTACTCATCT -> CTACTCATCTA
CCTAGCTATTC -> CTAGCTATTCG
CCTAGGCTGGG -> CTAGGCTGGGA
CCTATGACCCA -> CTATGACCCAT
CCTCAATTATA -> CTCAATTATAA
CCTCAGATACA -> CTCAGATACAA
CCTCCCACGAT -> CTCCCACGATT
CCTCCCGCGAA -> CTCCCGCGAAG
CCTCCGACGTC -> CTCCGACGTCG
CCTCCGATTGC -> CTCCGATTGCC
CCTCCGTACAA -> CTCCGTACAAA
CCTCCTTTCCT -> CTCCTTTCCTG
CCTCGAACGGG -> CTCGAACGGGA
CCTCGGTGGTG -> CTCGGTGGTGA
CCTCTAACATA -> CTCTAACATAC
CCTCTTGGTCG -> CTCTTGGTCGT
CCTGCTCCGCC -> CTGCTCCGCCG
CCTGGAACTGT -> CTGGAACTGTA
CCTGGCCATTT -> CTGGCCATTTC
CCTGGCTAGCC -> CTGGCTAGCCT
CCTGGGCGCCT -> CTGGGCGCCTC
CCTGGTGAGCG -> CTGGTGAGCGC
CCTGGTTTACC -> CTGGTTTACCA
CCTGTAACGTT -> CTGTAACGTTG
CCTGTGTGAAC -> CTGTGTGAACC
CCTTAGTTTTC -> CTTAGTTTTCC
CCTTATTTACT -> CTTATTTACTC
CCTTCTCTAGA -> CTTCTCTAGAG
CCTTCTTATGA -> CTTCTTATGAA
CCTTGGACCAT -> CTTGGACCATC
CCTTGTCACCC -> CTTGTCACCCA
CCTTTCCTGCT -> CTTTCCTGCTC
CCTTTCGAACC -> CTTTCGAACCC
CCTTTTCGGAA -> CTTTTCGGAAC
CGAACACTCGT -> GAACACTCGTG
CGAACCCGGGA -> GAACCCGGGAC
CGAACGGGATT -> GAACGGGATTC
CGAACTCGGCT -> GAACTCGGCTC
CGAAGCTTATA -> GAAGCTTATAT
CGAATTGTTTA -> GAATTGTTTAT
CGACAACTCTC -> GACAACTCTCG
CGACAATGAGG -> GACAATGAGGT
CGACACGGCCA -> GACACGGCCAT
CGACACTCGAA -> GACACTCGAAC
CGACAGAGGCT -> GACAGAGGCTT
CGACAGAGGTC -> GACAGAGGTCC
CGACATATACC -> GACATATACCA
CGACCACGGAT -> GACCACGGATT
CGACCCATATC -> GACCCATATCC
CGACCGATTTT -> GACCGATTTTA
CGACGCTGAGG -> GACGCTGAGGG
CGACGTCGGCT -> GACGTCGGCTA
CGACTAGTTAC -> GACTAGTTACT
CGACTCCCATT -> GACTCCCATTC
CGACTTTTAAA -> GACTTTTAAAG
CGACTTTTCCT -> GACTTTTCCTG
CGAGAAGTGTA -> GAGAAGTGTAC
CGAGACGCGCA -> GAGACGCGCAG
CGAGAGAAGTG -> GAGAGAAGTGG
CGAGAGGGATT -> GAGAGGGATTT
CGAGAGTGAAA -> GAGAGTGAAAC
CGAGATATCCC -> GAGATATCCCG
CGAGCGCGGAA -> GAGCGCGGAAG
CGAGCTACGTG -> GAGCTACGTGC
CGAGTCCGATG -> GAGTCCGATGA
CGATCTATTGC -> GATCTATTGCC
CGATGAGCCTC -> GATGAGCCTCC
CGATGAGGTGT -> GATGAGGTGTT
CGATTCTGTCA -> GATTCTGTCAA
CGATTGCCGTT -> GATTGCCGTTT
CGATTTTACAG -> GATTTTACAGA
CGCAATGTCAG -> GCAATGTCAGT
CGCACCAGCAA -> GCACCAGCAAG
CGCAGACTCCG -> GCAGACTCCGG
CGCAGCTAAAC -> GCAGCTAAACG
CGCAGGCTGCG -> GCAGGCTGCGC
CGCCATGGCCA -> GCCATGGCCAC
CGCCCAGCTAG -> GCCCAGCTAGA
CGCCCTCCGAC -> GCCCTCCGACG
CGCCGGGATAT -> GCCGGGATATC
CGCCTAGGCTG -> GCCTAGGCTGG
CGCCTCCTTTC -> GCCTCCTTTCC
CGCCTCGAACG -> GCCTCGAACGG
CGCGAAGCTTA -> GCGAAGCTTAT
CGCGACCCATA -> GCGACCCATAT
CGCGAGCTACG -> GCGAGCTACGT
CGCGAGTCCGA -> GCGAGTCCGAT
CGCGCAATGTC -> GCGCAATGTCA
CGCGCAGACTC -> GCGCAGACTCC
CGCGCAGCTAA -> GCGCAGCTAAA
CGCGCGACCCA -> GCGCGACCCAT
CGCGCTGAATG -> GCGCTGAATGT
CGCGGAAGGGG -> GCGGAAGGGGC
CGCGGGGAGCT -> GCGGGGAGCTG
CGCTAATGCTG -> GCTAATGCTGA
CGCTACCAAGC -> GCTACCAAGCA
CGCTACTTAAT -> GCTACTTAATA
CGCTATATGCT -> GCTATATGCTG
CGCTCCACAAG -> GCTCCACAAGT
CGCTCGTGCCG -> GCTCGTGCCGT
CGCTGAATGTG -> GCTGAATGTGT
CGCTGAGGGAT -> GCTGAGGGATG
CGCTTATCGAC -> GCTTATCGACA
CGGAACGACAG -> GGAACGACAGA
CGGAAGGGGCC -> GGAAGGGGCCT
CGGACCATCCT -> GGACCATCCTT
CGGAGCTAATA -> GGAGCTAATAA
CGGATCACAGA -> GGATCACAGAG
CGGATTGCTTA -> GGATTGCTTAA
CGGCACAATCC -> GGCACAATCCC
CGGCAGGGGTG -> GGCAGGGGTGA
CGGCATTGTTT -> GGCATTGTTTT
CGGCCATTGGG -> GGCCATTGGGT
CGGCCTCGGTG -> GGCCTCGGTGG
CGGCCTTCTTA -> GGCCTTCTTAT
CGGCTACGGCA -> GGCTACGGCAC
CGGCTCGGCTC -> GGCTCGGCTCT
CGGCTCTCCCC -> GGCTCTCCCCG
CGGGACCGGCC -> GGGACCGGCCT
CGGGACGTGGG -> GGGACGTGGGT
CGGGATATCCA -> GGGATATCCAG
CGGGATTCACC -> GGGATTCACCG
CGGGCAATTTA -> GGGCAATTTAT
CGGGCAGCAGG -> GGGCAGCAGGG
CGGGGAGCTGC -> GGGGAGCTGCC
CGGGGCCGACA -> GGGGCCGACAT
CGGTAAAAGCC -> GGTAAAAGCCC
CGGTAAACGGT -> GGTAAACGGTG
CGGTAATAGAC -> GGTAATAGACC
CGGTACCTCCC -> GGTACCTCCCG
CGGTGGATGAT -> GGTGGATGATT
CGGTGGTGACC -> GGTGGTGACCG
CGGTGTGTGCA -> GGTGTGTGCAC
CGGTTACTCTG -> GGTTACTCTGA
CGGTTAGGAGC -> GGTTAGGAGCA
CGTAAAGAGTT -> GTAAAGAGTTC
CGTACAAATGA -> GTACAAATGAT
CGTAGTTCCAG -> GTAGTTCCAGA
CGTCATGGTGA -> GTCATGGTGAA
CGTCATGGTGT -> GTCATGGTGTT
CGTCCCCCAAG -> GTCCCCCAAGG
CGTCCTACTCA -> GTCCTACTCAT
CGTCCTATGAC -> GTCCTATGACC
CGTCCTCAGAT -> GTCCTCAGATA
CGTCGGCTACG -> GTCGGCTACGG
CGTCTCGCGCG -> GTCTCGCGCGA
CGTGACCGCGG -> GTGACCGCGGG
CGTGATTGCTG -> GTGATTGCTGA
CGTGCCAACGT -> GTGCCAACGTG
CGTGCCGTGAT -> GTGCCGTGATT
CGTGCTAGAAA -> GTGCTAGAAAT
CGTGGGTCGTC -> GTGGGTCGTCA
CGTGTAGACAC -> GTGTAGACACT
CGTGTTTTTAT -> GTGTTTTTATG
CGTTAAAACGG -> GTTAAAACGGG
CGTTGTCCAAT -> GTTGTCCAATA
CGTTGTGAGTA -> GTTGTGAGTAC
CGTTTACGAGA -> GTTTACGAGAC
CGTTTCTACGC -> GTTTCTACGCT
CTAAACGGCCT -> TAAACGGCCTT
CTAACAGCTCC -> TAACAGCTCCA
CTAACATACCA -> TAACATACCAT
CTAACTTCTGG -> TAACTTCTGGT
CTAATAACAGA -> TAATAACAGAC
CTAATGCTGAA -> TAATGCTGAAA
CTAATTCGACT -> TAATTCGACTT
CTACATCCCCA -> TACATCCCCAC
CTACCAAGCAG -> TACCAAGCAGT
CTACCCGATGA -> TACCCGATGAG
CTACCCGGTTA -> TACCCGGTTAC
CTACCGACAGA -> TACCGACAGAG
CTACGCTTATC -> TACGCTTATCG
CTACGGCACAA -> TACGGCACAAT
CTACGTGCCAA -> TACGTGCCAAC
CTACGTGTTTT -> TACGTGTTTTT
CTACTCATCTA -> TACTCATCTAT
CTACTTAATAA -> TACTTAATAAC
CTAGAAATTAT -> TAGAAATTATC
CTAGAGAATCC -> TAGAGAATCCC
CTAGATTACTG -> TAGATTACTGG
CTAGCCTCTTG -> TAGCCTCTTGG
CTAGCTATTCG -> TAGCTATTCGC
CTAGGCTGGGA -> TAGGCTGGGAC
CTAGTTACTCC -> TAGTTACTCCA
CTATATGCTGA -> TATATGCTGAC
CTATGACCAAC -> TATGACCAACC
CTATGACCCAT -> TATGACCCATT
CTATGCCCCCC -> TATGCCCCCCG
CTATTATTATC -> TATTATTATCA
CTATTCGCCCA -> TATTCGCCCAG
CTATTGCCACC -> TATTGCCACCC
CTCAATTATAA -> TCAATTATAAG
CTCACCTTCTC -> TCACCTTCTCT
CTCAGATACAA -> TCAGATACAAC
CTCAGCCAAGG -> TCAGCCAAGGG
CTCAGGGCTAC -> TCAGGGCTACG
CTCATCTATTA -> TCATCTATTAT
CTCATGAAGAA -> TCATGAAGAAA
CTCATTTGTTT -> TCATTTGTTTA
CTCCACAAGTT -> TCCACAAGTTG
CTCCACTCCAG -> TCCACTCCAGT
CTCCAGAATCC -> TCCAGAATCCT
CTCCAGACTAA -> TCCAGACTAAC
CTCCAGTCACA -> TCCAGTCACAT
CTCCCACGATT -> TCCCACGATTC
CTCCCATTCGG -> TCCCATTCGGT
CTCCCCGACTC -> TCCCCGACTCC
CTCCCGCGAAG -> TCCCGCGAAGC
CTCCGACGTCG -> TCCGACGTCGG
CTCCGATTGCC -> TCCGATTGCCG
CTCCGCCGGGA -> TCCGCCGGGAT
CTCCGGCATTG -> TCCGGCATTGT
CTCCGTACAAA -> TCCGTACAAAT
CTCCTTTCCTG -> TCCTTTCCTGC
CTCGAACACTC -> TCGAACACTCG
CTCGAACGGGA -> TCGAACGGGAT
CTCGAATTGTT -> TCGAATTGTTT
CTCGACAATGA -> TCGACAATGAG
CTCGCGCGACC -> TCGCGCGACCC
CTCGGAGCTAA -> TCGGAGCTAAT
CTCGGCTCGGC -> TCGGCTCGGCT
CTCGGCTCTCC -> TCGGCTCTCCC
CTCGGTGGTGA -> TCGGTGGTGAC
CTCGTCATGGT -> TCGTCATGGTG
CTCGTGCCGTG -> TCGTGCCGTGA
CTCGTGTAGAC -> TCGTGTAGACA
CTCGTTAAAAC -> TCGTTAAAACG
CTCTAACATAC -> TCTAACATACC
CTCTAGAGAAT -> TCTAGAGAATC
CTCTCATTTGT -> TCTCATTTGTT
CTCTCCCCGAC -> TCTCCCCGACT
CTCTCGGAGCT -> TCTCGGAGCTA
CTCTGAGACAT -> TCTGAGACATG
CTCTTGGTCGT -> TCTTGGTCGTC
CTGAAATCGCT -> TGAAATCGCTC
CTGAATGTGTG -> TGAATGTGTGC
CTGACGGCAGG -> TGACGGCAGGG
CTGACTGCCTT -> TGACTGCCTTA
CTGAGACATGC -> TGAGACATGCT
CTGAGGGATGG -> TGAGGGATGGG
CTGATGACCCA -> TGATGACCCAG
CTGATGCTGAT -> TGATGCTGATG
CTGATTCCGCA -> TGATTCCGCAG
CTGCCCCGCAC -> TGCCCCGCACC
CTGCCTTATTT -> TGCCTTATTTA
CTGCGCGAGTC -> TGCGCGAGTCC
CTGCTCCGCCG -> TGCTCCGCCGG
CTGGAACTGTA -> TGGAACTGTAG
CTGGATAATGA -> TGGATAATGAT
CTGGCATAGAG -> TGGCATAGAGT
CTGGCCATTTC -> TGGCCATTTCA
CTGGCTAGCCT -> TGGCTAGCCTC
CTGGGAAACGT -> TGGGAAACGTT
CTGGGACGAGA -> TGGGACGAGAA
CTGGGCGCCTC -> TGGGCGCCTCC
CTGGTACACTC -> TGGTACACTCG
CTGGTGAGCGC -> TGGTGAGCGCC
CTGGTTTACCA -> TGGTTTACCAA
CTGTAACGTTG -> TGTAACGTTGT
CTGTAGTCAGT -> TGTAGTCAGTT
CTGTCAAGGAG -> TGTCAAGGAGC
CTGTGAAACGC -> TGTGAAACGCG
CTGTGTGAACC -> TGTGTGAACCC
CTGTTATCGTC -> TGTTATCGTCC
CTTAAACCTGG -> TTAAACCTGGT
CTTAATAACTT -> TTAATAACTTT
CTTACACGCCC -> TTACACGCCCT
CTTAGTTTTCC -> TTAGTTTTCCC
CTTATATGTTG -> TTATATGTTGA
CTTATCGACAC -> TTATCGACACG
CTTATGAATGT -> TTATGAATGTG
CTTATTAATCA -> TTATTAATCAT
CTTATTTACTC -> TTATTTACTCC
CTTCTCTAGAG -> TTCTCTAGAGA
CTTCTGGTACA -> TTCTGGTACAC
CTTCTTATGAA -> TTCTTATGAAT
CTTGCCCTTGT -> TTGCCCTTGTC
CTTGGACCATC -> TTGGACCATCG
CTTGGTCGTCT -> TTGGTCGTCTC
CTTGTCACCCA -> TTGTCACCCAG
CTTTCCTGCTC -> TTTCCTGCTCC
CTTTCGAACCC -> TTTCGAACCCG
CTTTCGGGACC -> TTTCGGGACCG
CTTTGGGGCAT -> TTTGGGGCATC
CTTTTAAAGTA -> TTTTAAAGTAA
CTTTTCCTGTA -> TTTTCCTGTAA
CTTTTCGGAAC -> TTTTCGGAACG
CTTTTGACCTG -> TTTTGACCTGT
GAAAAAGTACG -> AAAAAGTACGC
GAAACGCGAGC -> AAACGCGAGCT
GAAACGTAAAG -> AAACGTAAAGA
GAAACGTTGTG -> AAACGTTGTGA
GAAAGCTACCG -> AAAGCTACCGA
GAAATAAATTC -> AAATAAATTCA
GAAATCGCTCG -> AAATCGCTCGT
GAAATTATCGA -> AAATTATCGAC
GAACACTCGTG -> AACACTCGTGT
GAACAGTGACG -> AACAGTGACGA
GAACCCGGGAC -> AACCCGGGACG
GAACCCTGGGC -> AACCCTGGGCG
GAACGACAGAG -> AACGACAGAGG
GAACGCGCAGC -> AACGCGCAGCT
GAACGGGATTC -> AACGGGATTCA
GAACTCGGCTC -> AACTCGGCTCG
GAACTGTAGTC -> AACTGTAGTCA
GAAGAAAAAGT -> AAGAAAAAGTA
GAAGCTTATAT -> AAGCTTATATG
GAAGGCTCAGC -> AAGGCTCAGCC
GAAGGGGCCTA -> AAGGGGCCTAG
GAAGTGGACTT -> AAGTGGACTTG
GAAGTGTACCT -> AAGTGTACCTT
GAATATCGCCT -> AATATCGCCTA
GAATCCCCAAT -> AATCCCCAATG
GAATCCTTAGT -> AATCCTTAGTT
GAATGTCCCGA -> AATGTCCCGAG
GAATGTGCCGA -> AATGTGCCGAG
GAATGTGTGCT -> AATGTGTGCTA
GAATTCTGGGA -> AATTCTGGGAA
GAATTGTTTAT -> AATTGTTTATC
GACAACCACCA -> ACAACCACCAC
GACAACTCTCG -> ACAACTCTCGG
GACAAGGACAA -> ACAAGGACAAC
GACAATAATGT -> ACAATAATGTC
GACAATGAGGT -> ACAATGAGGTA
GACACGGCCAT -> ACACGGCCATT
GACACTCGAAC -> ACACTCGAACA
GACACTGTGAA -> ACACTGTGAAA
GACACTTACAC -> ACACTTACACG
GACAGAGGCTT -> ACAGAGGCTTT
GACAGAGGTCC -> ACAGAGGTCCA
GACATATACCA -> ACATATACCAT
GACATGCTATG -> ACATGCTATGA
GACATGTCTGT -> ACATGTCTGTT
GACCAACCAAT -> ACCAACCAATT
GACCACGCTAC -> ACCACGCTACC
GACCACGGATT -> ACCACGGATTG
GACCATCCTTT -> ACCATCCTTTC
GACCATCGGGC -> ACCATCGGGCA
GACCCAGCAGA -> ACCCAGCAGAA
GACCCATATCC -> ACCCATATCCG
GACCCATTGTC -> ACCCATTGTCG
GACCCGTCCCC -> ACCCGTCCCCC
GACCGATTTTA -> ACCGATTTTAC
GACCGCGCTGA -> ACCGCGCTGAA
GACCGCGGGGA -> ACCGCGGGGAG
GACCGGCCTCG -> ACCGGCCTCGG
GACCGGTGTGT -> ACCGGTGTGTG
GACCTCTAACA -> ACCTCTAACAT
GACCTGTGTGA -> ACCTGTGTGAA
GACGACCACGG -> ACGACCACGGA
GACGAGAAGTG -> ACGAGAAGTGT
GACGCGCAGAC -> ACGCGCAGACT
GACGCTGAGGG -> ACGCTGAGGGA
GACGGCAGGGG -> ACGGCAGGGGT
GACGTCGGCTA -> ACGTCGGCTAC
GACGTGGGTCG -> ACGTGGGTCGT
GACTAACAGCT -> ACTAACAGCTC
GACTAGTTACT -> ACTAGTTACTC
GACTCATGAAG -> ACTCATGAAGA
GACTCCCATTC -> ACTCCCATTCG
GACTCCGGCAT -> ACTCCGGCATT
GACTGCCTTAT -> ACTGCCTTATT
GACTTATTAAT -> ACTTATTAATC
GACTTGCCCTT -> ACTTGCCCTTG
GACTTTTAAAG -> ACTTTTAAAGT
GACTTTTCCTG -> ACTTTTCCTGT
GAGAAGTGGAC -> AGAAGTGGACT
GAGAAGTGTAC -> AGAAGTGTACC
GAGAATCCCCA -> AGAATCCCCAA
GAGACATGCTA -> AGACATGCTAT
GAGACGCGCAG -> AGACGCGCAGA
GAGAGAAGTGG -> AGAGAAGTGGA
GAGAGGGATTT -> AGAGGGATTTG
GAGAGTGAAAC -> AGAGTGAAACG
GAGATATCCCG -> AGATATCCCGC
GAGCAGTAAAA -> AGCAGTAAAAA
GAGCCTCCGTA -> AGCCTCCGTAC
GAGCGACTAGT -> AGCGACTAGTT
GAGCGCCTCGA -> AGCGCCTCGAA
GAGCGCGGAAG -> AGCGCGGAAGG
GAGCTAATAAC -> AGCTAATAACA
GAGCTACGTGC -> AGCTACGTGCC
GAGCTGCCCCG -> AGCTGCCCCGC
GAGGACACTTA -> AGGACACTTAC
GAGGCACGAGA -> AGGCACGAGAT
GAGGCTTTGGG -> AGGCTTTGGGG
GAGGGATGGGC -> AGGGATGGGCC
GAGGGATTTGT -> AGGGATTTGTA
GAGGGTGACCT -> AGGGTGACCTC
GAGGTAACGTG -> AGGTAACGTGA
GAGGTCCATGT -> AGGTCCATGTT
GAGGTGACTCA -> AGGTGACTCAT
GAGGTGTTGCT -> AGGTGTTGCTC
GAGTACGGTTA -> AGTACGGTTAG
GAGTCCGATGA -> AGTCCGATGAG
GAGTGAAACGT -> AGTGAAACGTA
GAGTGGATTAA -> AGTGGATTAAA
GAGTTAATGAC -> AGTTAATGACA
GAGTTCGAGCG -> AGTTCGAGCGC
GATAATGATCC -> ATAATGATCCC
GATACAACGAC -> ATACAACGACC
GATATCCAGGA -> ATATCCAGGAG
GATATCCCGCT -> ATATCCCGCTC
GATATCCTGGC -> ATATCCTGGCT
GATCACAGAGG -> ATCACAGAGGC
GATCACTCGTC -> ATCACTCGTCA
GATCCATCCCA -> ATCCATCCCAC
GATCCCTCCCA -> ATCCCTCCCAC
GATCTATTGCC -> ATCTATTGCCA
GATGAATGTCC -> ATGAATGTCCC
GATGACCCAGC -> ATGACCCAGCA
GATGAGCCTCC -> ATGAGCCTCCG
GATGAGGTGTT -> ATGAGGTGTTG
GATGATTGCAA -> ATGATTGCAAT
GATGCTGATGA -> ATGCTGATGAC
GATGGGCCCCT -> ATGGGCCCCTT
GATGGTAAAAC -> ATGGTAAAACG
GATTAAACTAA -> ATTAAACTAAC
GATTACTGGAT -> ATTACTGGATA
GATTAGGTCGA -> ATTAGGTCGAT
GATTCACCGGT -> ATTCACCGGTA
GATTCCGCAGG -> ATTCCGCAGGC
GATTCTGTCAA -> ATTCTGTCAAG
GATTGCAATCC -> ATTGCAATCCG
GATTGCCGTTT -> ATTGCCGTTTC
GATTGCTGATT -> ATTGCTGATTC
GATTGCTTAAA -> ATTGCTTAAAC
GATTTGTATTC -> ATTTGTATTCG
GATTTTACAGA -> ATTTTACAGAG
GCAAGTCTACC -> CAAGTCTACCC
GCAATCCGCTA -> CAATCCGCTAT
GCAATGTCAGT -> CAATGTCAGTG
GCAATTTATTG -> CAATTTATTGT
GCACAATCCCA -> CACAATCCCAA
GCACAGTATAA -> CACAGTATAAG
GCACCAGCAAG -> CACCAGCAAGT
GCACCTCCGAT -> CACCTCCGATT
GCACGAGATAT -> CACGAGATATC
GCACTCGAATT -> CACTCGAATTG
GCAGAATTCTG -> CAGAATTCTGG
GCAGACTCCGG -> CAGACTCCGGC
GCAGCAGGGGT -> CAGCAGGGGTT
GCAGCTAAACG -> CAGCTAAACGG
GCAGGCTGCGC -> CAGGCTGCGCG
GCAGGGGTGAA -> CAGGGGTGAAA
GCAGGGGTTAC -> CAGGGGTTACT
GCAGTAAAAAC -> CAGTAAAAACA
GCAGTTAGGCT -> CAGTTAGGCTT
GCATAGAGTTA -> CATAGAGTTAA
GCATCTATGCC -> CATCTATGCCC
GCATTGTTTTT -> CATTGTTTTTG
GCCAACGTGCT -> CCAACGTGCTA
GCCAAGGGCGG -> CCAAGGGCGGT
GCCACCCTGGA -> CCACCCTGGAA
GCCACTGGCAT -> CCACTGGCATA
GCCATGGCCAC -> CCATGGCCACT
GCCATTGGGTT -> CCATTGGGTTA
GCCATTTCAAG -> CCATTTCAAGC
GCCCAGCTAGA -> CCCAGCTAGAT
GCCCCCCGGTA -> CCCCCCGGTAA
GCCCCGCACCA -> CCCCGCACCAG
GCCCCTTTTCG -> CCCCTTTTCGG
GCCCGGACCAT -> CCCGGACCATC
GCCCGTTTACG -> CCCGTTTACGA
GCCCTCCGACG -> CCCTCCGACGT
GCCCTTGTCAC -> CCCTTGTCACC
GCCGACATATA -> CCGACATATAC
GCCGAGAGTGA -> CCGAGAGTGAA
GCCGGGATATC -> CCGGGATATCC
GCCGTGATTGC -> CCGTGATTGCT
GCCGTTTCTAC -> CCGTTTCTACG
GCCTAGCTATT -> CCTAGCTATTC
GCCTAGGCTGG -> CCTAGGCTGGG
GCCTCAATTAT -> CCTCAATTATA
GCCTCCGTACA -> CCTCCGTACAA
GCCTCCTTTCC -> CCTCCTTTCCT
GCCTCGAACGG -> CCTCGAACGGG
GCCTCGGTGGT -> CCTCGGTGGTG
GCCTCTTGGTC -> CCTCTTGGTCG
GCCTGGTGAGC -> CCTGGTGAGCG
GCCTTATTTAC -> CCTTATTTACT
GCCTTCTTATG -> CCTTCTTATGA
GCGAAGCTTAT -> CGAAGCTTATA
GCGACCCATAT -> CGACCCATATC
GCGACTAGTTA -> CGACTAGTTAC
GCGAGCTACGT -> CGAGCTACGTG
GCGAGTCCGAT -> CGAGTCCGATG
GCGCAATGTCA -> CGCAATGTCAG
GCGCAGACTCC -> CGCAGACTCCG
GCGCAGCTAAA -> CGCAGCTAAAC
GCGCCTCCTTT -> CGCCTCCTTTC
GCGCCTCGAAC -> CGCCTCGAACG
GCGCGACCCAT -> CGCGACCCATA
GCGCGAGTCCG -> CGCGAGTCCGA
GCGCGGAAGGG -> CGCGGAAGGGG
GCGCTGAATGT -> CGCTGAATGTG
GCGGAAGGGGC -> CGGAAGGGGCC
GCGGATCACAG -> CGGATCACAGA
GCGGGGAGCTG -> CGGGGAGCTGC
GCGGTAAACGG -> CGGTAAACGGT
GCTAAACGGCC -> CTAAACGGCCT
GCTAATAACAG -> CTAATAACAGA
GCTAATGCTGA -> CTAATGCTGAA
GCTAATTCGAC -> CTAATTCGACT
GCTACCAAGCA -> CTACCAAGCAG
GCTACCGACAG -> CTACCGACAGA
GCTACGGCACA -> CTACGGCACAA
GCTACGTGCCA -> CTACGTGCCAA
GCTACGTGTTT -> CTACGTGTTTT
GCTACTTAATA -> CTACTTAATAA
GCTAGAAATTA -> CTAGAAATTAT
GCTAGATTACT -> CTAGATTACTG
GCTAGCCTCTT -> CTAGCCTCTTG
GCTATATGCTG -> CTATATGCTGA
GCTATGACCAA -> CTATGACCAAC
GCTATTCGCCC -> CTATTCGCCCA
GCTCACCTTCT -> CTCACCTTCTC
GCTCAGCCAAG -> CTCAGCCAAGG
GCTCAGGGCTA -> CTCAGGGCTAC
GCTCCACAAGT -> CTCCACAAGTT
GCTCCACTCCA -> CTCCACTCCAG
GCTCCGCCGGG -> CTCCGCCGGGA
GCTCGGCTCTC -> CTCGGCTCTCC
GCTCGTGCCGT -> CTCGTGCCGTG
GCTCTCCCCGA -> CTCTCCCCGAC
GCTGAAATCGC -> CTGAAATCGCT
GCTGAATGTGT -> CTGAATGTGTG
GCTGACGGCAG -> CTGACGGCAGG
GCTGAGGGATG -> CTGAGGGATGG
GCTGATGACCC -> CTGATGACCCA
GCTGATGCTGA -> CTGATGCTGAT
GCTGATTCCGC -> CTGATTCCGCA
GCTGCCCCGCA -> CTGCCCCGCAC
GCTGCGCGAGT -> CTGCGCGAGTC
GCTGGGACGAG -> CTGGGACGAGA
GCTTAAACCTG -> CTTAAACCTGG
GCTTATATGTT -> CTTATATGTTG
GCTTATCGACA -> CTTATCGACAC
GCTTTCGGGAC -> CTTTCGGGACC
GCTTTGGGGCA -> CTTTGGGGCAT
GGAAACGTTGT -> GAAACGTTGTG
GGAACGACAGA -> GAACGACAGAG
GGAACTGTAGT -> GAACTGTAGTC
GGAAGGGGCCT -> GAAGGGGCCTA
GGACAACCACC -> GACAACCACCA
GGACAAGGACA -> GACAAGGACAA
GGACACTTACA -> GACACTTACAC
GGACATGTCTG -> GACATGTCTGT
GGACCATCCTT -> GACCATCCTTT
GGACCATCGGG -> GACCATCGGGC
GGACCGGCCTC -> GACCGGCCTCG
GGACGAGAAGT -> GACGAGAAGTG
GGACGTGGGTC -> GACGTGGGTCG
GGACTTGCCCT -> GACTTGCCCTT
GGAGCAGTAAA -> GAGCAGTAAAA
GGAGCGACTAG -> GAGCGACTAGT
GGAGCTAATAA -> GAGCTAATAAC
GGAGCTGCCCC -> GAGCTGCCCCG
GGAGGTGACTC -> GAGGTGACTCA
GGATAATGATC -> GATAATGATCC
GGATATCCAGG -> GATATCCAGGA
GGATCACAGAG -> GATCACAGAGG
GGATGATTGCA -> GATGATTGCAA
GGATGGGCCCC -> GATGGGCCCCT
GGATTAAACTA -> GATTAAACTAA
GGATTCACCGG -> GATTCACCGGT
GGATTGCTTAA -> GATTGCTTAAA
GGATTTGTATT -> GATTTGTATTC
GGCAATTTATT -> GCAATTTATTG
GGCACAATCCC -> GCACAATCCCA
GGCACCTCCGA -> GCACCTCCGAT
GGCACGAGATA -> GCACGAGATAT
GGCAGCAGGGG -> GCAGCAGGGGT
GGCAGGGGTGA -> GCAGGGGTGAA
GGCATAGAGTT -> GCATAGAGTTA
GGCATCTATGC -> GCATCTATGCC
GGCATTGTTTT -> GCATTGTTTTT
GGCCACTGGCA -> GCCACTGGCAT
GGCCATTGGGT -> GCCATTGGGTT
GGCCATTTCAA -> GCCATTTCAAG
GGCCCCTTTTC -> GCCCCTTTTCG
GGCCCGTTTAC -> GCCCGTTTACG
GGCCGACATAT -> GCCGACATATA
GGCCTAGCTAT -> GCCTAGCTATT
GGCCTCAATTA -> GCCTCAATTAT
GGCCTCGGTGG -> GCCTCGGTGGT
GGCCTTCTTAT -> GCCTTCTTATG
GGCGCCTCCTT -> GCGCCTCCTTT
GGCGGTAAACG -> GCGGTAAACGG
GGCTACGGCAC -> GCTACGGCACA
GGCTACGTGTT -> GCTACGTGTTT
GGCTAGCCTCT -> GCTAGCCTCTT
GGCTCAGCCAA -> GCTCAGCCAAG
GGCTCGGCTCT -> GCTCGGCTCTC
GGCTCTCCCCG -> GCTCTCCCCGA
GGCTGCGCGAG -> GCTGCGCGAGT
GGCTGGGACGA -> GCTGGGACGAG
GGCTTTCGGGA -> GCTTTCGGGAC
GGCTTTGGGGC -> GCTTTGGGGCA
GGGAAACGTTG -> GGAAACGTTGT
GGGACCGGCCT -> GGACCGGCCTC
GGGACGAGAAG -> GGACGAGAAGT
GGGACGTGGGT -> GGACGTGGGTC
GGGAGCTGCCC -> GGAGCTGCCCC
GGGATATCCAG -> GGATATCCAGG
GGGATGGGCCC -> GGATGGGCCCC
GGGATTCACCG -> GGATTCACCGG
GGGATTTGTAT -> GGATTTGTATT
GGGCAATTTAT -> GGCAATTTATT
GGGCACCTCCG -> GGCACCTCCGA
GGGCAGCAGGG -> GGCAGCAGGGG
GGGCATCTATG -> GGCATCTATGC
GGGCCCCTTTT -> GGCCCCTTTTC
GGGCCGACATA -> GGCCGACATAT
GGGCCTAGCTA -> GGCCTAGCTAT
GGGCGCCTCCT -> GGCGCCTCCTT
GGGCGGTAAAC -> GGCGGTAAACG
GGGCTACGTGT -> GGCTACGTGTT
GGGGAGCTGCC -> GGGAGCTGCCC
GGGGCACCTCC -> GGGCACCTCCG
GGGGCATCTAT -> GGGCATCTATG
GGGGCCGACAT -> GGGCCGACATA
GGGGCCTAGCT -> GGGCCTAGCTA
GGGGTGAAATA -> GGGTGAAATAA
GGGGTTACTGA -> GGGTTACTGAC
GGGTCGTCATG -> GGTCGTCATGG
GGGTGAAATAA -> GGTGAAATAAA
GGGTGACCTCT -> GGTGACCTCTA
GGGTTACTGAC -> GGTTACTGACT
GGGTTAGATCC -> GGTTAGATCCA
GGTAAAACGAG -> GTAAAACGAGA
GGTAAAAGCCC -> GTAAAAGCCCG
GGTAAACGGTG -> GTAAACGGTGG
GGTAACGTGAC -> GTAACGTGACC
GGTAATAGACC -> GTAATAGACCA
GGTACACTCGA -> GTACACTCGAC
GGTACCTCCCG -> GTACCTCCCGC
GGTCCATGTTT -> GTCCATGTTTA
GGTCGATCTAT -> GTCGATCTATT
GGTCGTCATGG -> GTCGTCATGGT
GGTCGTCTCGC -> GTCGTCTCGCG
GGTGAAATAAA -> GTGAAATAAAT
GGTGAATATCG -> GTGAATATCGC
GGTGACCGGTG -> GTGACCGGTGT
GGTGACCTCTA -> GTGACCTCTAA
GGTGACTCATG -> GTGACTCATGA
GGTGAGCGCCT -> GTGAGCGCCTC
GGTGAGGACAC -> GTGAGGACACT
GGTGGATGATT -> GTGGATGATTG
GGTGGTGACCG -> GTGGTGACCGG
GGTGTGTGCAC -> GTGTGTGCACT
GGTGTTCCTGG -> GTGTTCCTGGC
GGTGTTGCTCA -> GTGTTGCTCAG
GGTTACTCTGA -> GTTACTCTGAG
GGTTACTGACT -> GTTACTGACTG
GGTTAGATCCA -> GTTAGATCCAT
GGTTAGGAGCA -> GTTAGGAGCAG
GGTTTACCAAG -> GTTTACCAAGA
GTAAAAACAAT -> TAAAAACAATC
GTAAAACGAGA -> TAAAACGAGAG
GTAAAAGCCCG -> TAAAAGCCCGG
GTAAACGGTGG -> TAAACGGTGGA
GTAAAGAGTTC -> TAAAGAGTTCG
GTAACGTGACC -> TAACGTGACCG
GTAACGTTGTC -> TAACGTTGTCC
GTAAGACCGCG -> TAAGACCGCGC
GTAATAGACCA -> TAATAGACCAC
GTACAAATGAT -> TACAAATGATT
GTACACTCGAC -> TACACTCGACA
GTACCTCCCGC -> TACCTCCCGCG
GTACCTTGGAC -> TACCTTGGACC
GTACGCTAATG -> TACGCTAATGC
GTACGGTTAGG -> TACGGTTAGGA
GTAGACACTGT -> TAGACACTGTG
GTAGTCAGTTG -> TAGTCAGTTGC
GTAGTTCCAGA -> TAGTTCCAGAT
GTATAAGATGG -> TATAAGATGGT
GTATTAGAACA -> TATTAGAACAG
GTATTCGACAA -> TATTCGACAAC
GTCAAGGAGCG -> TCAAGGAGCGA
GTCACATGAAG -> TCACATGAAGG
GTCACCCAGAG -> TCACCCAGAGT
GTCAGTATTAG -> TCAGTATTAGA
GTCAGTGTCTA -> TCAGTGTCTAC
GTCAGTTGCCT -> TCAGTTGCCTG
GTCATGGTGAA -> TCATGGTGAAT
GTCATGGTGTT -> TCATGGTGTTC
GTCCAATAGAC -> TCCAATAGACT
GTCCATGTTTA -> TCCATGTTTAG
GTCCCCCAAGG -> TCCCCCAAGGA
GTCCCGAGAGA -> TCCCGAGAGAA
GTCCGATGAGG -> TCCGATGAGGT
GTCCTACTCAT -> TCCTACTCATC
GTCCTATGACC -> TCCTATGACCC
GTCCTCAGATA -> TCCTCAGATAC
GTCGACACTCG -> TCGACACTCGA
GTCGATCTATT -> TCGATCTATTG
GTCGCCATGGC -> TCGCCATGGCC
GTCGGCTACGG -> TCGGCTACGGC
GTCGTCATGGT -> TCGTCATGGTG
GTCGTCTCGCG -> TCGTCTCGCGC
GTCTACATCCC -> TCTACATCCCC
GTCTACCCGAT -> TCTACCCGATG
GTCTACCCGGT -> TCTACCCGGTT
GTCTCGCGCGA -> TCTCGCGCGAC
GTCTGTTATCG -> TCTGTTATCGT
GTGAAACGCGA -> TGAAACGCGAG
GTGAAACGTAA -> TGAAACGTAAA
GTGAAATAAAT -> TGAAATAAATT
GTGAACCCTGG -> TGAACCCTGGG
GTGAATATCGC -> TGAATATCGCC
GTGACCGCGGG -> TGACCGCGGGG
GTGACCGGTGT -> TGACCGGTGTG
GTGACCTCTAA -> TGACCTCTAAC
GTGACGACCAC -> TGACGACCACG
GTGACTCATGA -> TGACTCATGAA
GTGAGCGCCTC -> TGAGCGCCTCG
GTGAGGACACT -> TGAGGACACTT
GTGAGTACGGT -> TGAGTACGGTT
GTGATTGCTGA -> TGATTGCTGAT
GTGCACTCGAA -> TGCACTCGAAT
GTGCCAACGTG -> TGCCAACGTGC
GTGCCGAGAGT -> TGCCGAGAGTG
GTGCCGTGATT -> TGCCGTGATTG
GTGCTAATTCG -> TGCTAATTCGA
GTGCTAGAAAT -> TGCTAGAAATT
GTGGACTTGCC -> TGGACTTGCCC
GTGGATGATTG -> TGGATGATTGC
GTGGATTAAAC -> TGGATTAAACT
GTGGCCTCAAT -> TGGCCTCAATT
GTGGGTCGTCA -> TGGGTCGTCAT
GTGGTGACCGG -> TGGTGACCGGT
GTGTACCTTGG -> TGTACCTTGGA
GTGTAGACACT -> TGTAGACACTG
GTGTCTACCCG -> TGTCTACCCGG
GTGTGAACCCT -> TGTGAACCCTG
GTGTGCACTCG -> TGTGCACTCGA
GTGTGCTAATT -> TGTGCTAATTC
GTGTGTGCACT -> TGTGTGCACTC
GTGTTCCTGGC -> TGTTCCTGGCC
GTGTTGCTCAG -> TGTTGCTCAGG
GTGTTTTTATG -> TGTTTTTATGA
GTTAAAACGGG -> TTAAAACGGGG
GTTAATGACAA -> TTAATGACAAT
GTTACTCCAGA -> TTACTCCAGAC
GTTACTCTGAG -> TTACTCTGAGA
GTTACTGACTG -> TTACTGACTGC
GTTAGATCCAT -> TTAGATCCATC
GTTAGGAGCAG -> TTAGGAGCAGT
GTTAGGCTTTC -> TTAGGCTTTCG
GTTATCGTCCT -> TTATCGTCCTA
GTTCCAGATGA -> TTCCAGATGAA
GTTCCTGGCCA -> TTCCTGGCCAT
GTTCGAGCGCG -> TTCGAGCGCGG
GTTGAAAGCTA -> TTGAAAGCTAC
GTTGCCTGGTG -> TTGCCTGGTGA
GTTGCTCAGGG -> TTGCTCAGGGC
GTTGGCCCGTT -> TTGGCCCGTTT
GTTGTCCAATA -> TTGTCCAATAG
GTTGTGAGTAC -> TTGTGAGTACG
GTTTAAACACG -> TTTAAACACGC
GTTTACCAAGA -> TTTACCAAGAA
GTTTACGAGAC -> TTTACGAGACG
GTTTAGTGGCC -> TTTAGTGGCCT
GTTTATCAAAG -> TTTATCAAAGG
GTTTCTACGCT -> TTTCTACGCTT
GTTTTCCCACC -> TTTTCCCACCC
GTTTTTATGAT -> TTTTTATGATA
GTTTTTGCTCA -> TTTTTGCTCAC
TAAAAACAATC -> AAAAACAATCA
TAAAACGAGAG -> AAAACGAGAGG
TAAAACGGGGC -> AAAACGGGGCC
TAAAAGCCCGG -> AAAAGCCCGGA
TAAACACGCGC -> AAACACGCGCA
TAAACCTGGTT -> AAACCTGGTTT
TAAACGGCCTT -> AAACGGCCTTC
TAAACGGTGGA -> AAACGGTGGAT
TAAACTAACTT -> AAACTAACTTC
TAAAGAGTTCG -> AAAGAGTTCGA
TAAAGTAAGAC -> AAAGTAAGACC
TAAATTCACGA -> AAATTCACGAA
TAACAGACCCG -> AACAGACCCGT
TAACAGCTCCA -> AACAGCTCCAC
TAACATACCAT -> AACATACCATT
TAACGTCCTCA -> AACGTCCTCAG
TAACGTGACCG -> AACGTGACCGC
TAACGTTGTCC -> AACGTTGTCCA
TAACTTCTGGT -> AACTTCTGGTA
TAACTTTTGAC -> AACTTTTGACC
TAAGACCGCGC -> AAGACCGCGCT
TAAGATGGTAA -> AAGATGGTAAA
TAAGCTGATGC -> AAGCTGATGCT
TAATAACAGAC -> AATAACAGACC
TAATAACTTTT -> AATAACTTTTG
TAATAGACCAC -> AATAGACCACG
TAATCATATGA -> AATCATATGAT
TAATGACAATA -> AATGACAATAA
TAATGATCCCT -> AATGATCCCTC
TAATGCTGAAA -> AATGCTGAAAT
TAATGTCAGTA -> AATGTCAGTAT
TAATTCGACTT -> AATTCGACTTT
TACAAATGATT -> ACAAATGATTA
TACAACGACCG -> ACAACGACCGA
TACACGCCCTC -> ACACGCCCTCC
TACACTCGACA -> ACACTCGACAA
TACAGAGGGTG -> ACAGAGGGTGA
TACATCCCCAC -> ACATCCCCACG
TACCAAGAACG -> ACCAAGAACGC
TACCAAGCAGT -> ACCAAGCAGTT
TACCATAGTCT -> ACCATAGTCTA
TACCATTCTCG -> ACCATTCTCGT
TACCCGATGAG -> ACCCGATGAGC
TACCCGGTTAC -> ACCCGGTTACT
TACCGACAGAG -> ACCGACAGAGG
TACCTCCCGCG -> ACCTCCCGCGA
TACCTTGGACC -> ACCTTGGACCA
TACGAGACGCG -> ACGAGACGCGC
TACGCTAATGC -> ACGCTAATGCT
TACGCTTATCG -> ACGCTTATCGA
TACGGCACAAT -> ACGGCACAATC
TACGGTTAGGA -> ACGGTTAGGAG
TACGTGCCAAC -> ACGTGCCAACG
TACGTGTTTTT -> ACGTGTTTTTA
TACTCATCTAT -> ACTCATCTATT
TACTCCAGAAT -> ACTCCAGAATC
TACTCCAGACT -> ACTCCAGACTA
TACTCTGAGAC -> ACTCTGAGACA
TACTGACTGCC -> ACTGACTGCCT
TACTGGATAAT -> ACTGGATAATG
TACTTAATAAC -> ACTTAATAACT
TAGAAATTATC -> AGAAATTATCG
TAGAACAGTGA -> AGAACAGTGAC
TAGACACTGTG -> AGACACTGTGA
TAGACCACGCT -> AGACCACGCTA
TAGACTTATTA -> AGACTTATTAA
TAGAGAATCCC -> AGAGAATCCCC
TAGAGTTAATG -> AGAGTTAATGA
TAGATCCATCC -> AGATCCATCCC
TAGATTACTGG -> AGATTACTGGA
TAGCCTCTTGG -> AGCCTCTTGGT
TAGCTATTCGC -> AGCTATTCGCC
TAGGAGCAGTA -> AGGAGCAGTAA
TAGGCTGGGAC -> AGGCTGGGACG
TAGGCTTTCGG -> AGGCTTTCGGG
TAGGTCGATCT -> AGGTCGATCTA
TAGTCAGTTGC -> AGTCAGTTGCC
TAGTCTACATC -> AGTCTACATCC
TAGTGGCCTCA -> AGTGGCCTCAA
TAGTTACTCCA -> AGTTACTCCAG
TAGTTCCAGAT -> AGTTCCAGATG
TAGTTTTCCCA -> AGTTTTCCCAC
TATAAGATGGT -> ATAAGATGGTA
TATAAGCTGAT -> ATAAGCTGATG
TATACCATAGT -> ATACCATAGTC
TATATGCTGAC -> ATATGCTGACG
TATATGTTGAA -> ATATGTTGAAA
TATCAAAGGAC -> ATCAAAGGACA
TATCACCGCTA -> ATCACCGCTAC
TATCCAGGAGG -> ATCCAGGAGGT
TATCCCGCTCC -> ATCCCGCTCCA
TATCCGTAGTT -> ATCCGTAGTTC
TATCCTGGCTA -> ATCCTGGCTAG
TATCGACACGG -> ATCGACACGGC
TATCGACGCTG -> ATCGACGCTGA
TATCGCCTAGG -> ATCGCCTAGGC
TATCGTCCTAC -> ATCGTCCTACT
TATGAATGTGC -> ATGAATGTGCC
TATGACCAACC -> ATGACCAACCA
TATGACCCATT -> ATGACCCATTG
TATGATATCCT -> ATGATATCCTG
TATGATCACTC -> ATGATCACTCG
TATGCCCCCCG -> ATGCCCCCCGG
TATGCTGACGG -> ATGCTGACGGC
TATGTTGAAAG -> ATGTTGAAAGC
TATTAATCATA -> ATTAATCATAT
TATTAGAACAG -> ATTAGAACAGT
TATTATCACCG -> ATTATCACCGC
TATTATTATCA -> ATTATTATCAC
TATTCGACAAC -> ATTCGACAACT
TATTCGCCCAG -> ATTCGCCCAGC
TATTGCCACCC -> ATTGCCACCCT
TATTGTCGCCA -> ATTGTCGCCAT
TATTTACTCCA -> ATTTACTCCAG
TCAAAGGACAT -> CAAAGGACATG
TCAACCGACTT -> CAACCGACTTT
TCAAGCGGATC -> CAAGCGGATCA
TCAAGGAGCGA -> CAAGGAGCGAC
TCAATTATAAG -> CAATTATAAGC
TCACAGAGGCA -> CACAGAGGCAC
TCACATGAAGG -> CACATGAAGGC
TCACCCAGAGT -> CACCCAGAGTG
TCACCGCTACT -> CACCGCTACTT
TCACCGGTACC -> CACCGGTACCT
TCACCTTCTCT -> CACCTTCTCTA
TCACGAACTCG -> CACGAACTCGG
TCACTCGTCAT -> CACTCGTCATG
TCAGATACAAC -> CAGATACAACG
TCAGCCAAGGG -> CAGCCAAGGGC
TCAGGGCTACG -> CAGGGCTACGT
TCAGTATTAGA -> CAGTATTAGAA
TCAGTGTCTAC -> CAGTGTCTACC
TCAGTTGCCTG -> CAGTTGCCTGG
TCATATGATCA -> CATATGATCAC
TCATCTATTAT -> CATCTATTATT
TCATGAAGAAA -> CATGAAGAAAA
TCATGGTGAAT -> CATGGTGAATA
TCATGGTGTTC -> CATGGTGTTCC
TCATTTGTTTA -> CATTTGTTTAA
TCCAATAGACT -> CCAATAGACTT
TCCACAAGTTG -> CCACAAGTTGG
TCCACTCCAGT -> CCACTCCAGTC
TCCAGAATCCT -> CCAGAATCCTT
TCCAGACTAAC -> CCAGACTAACA
TCCAGATGAAT -> CCAGATGAATG
TCCAGGAGGTG -> CCAGGAGGTGA
TCCAGTCACAT -> CCAGTCACATG
TCCATCCCACT -> CCATCCCACTC
TCCATGTTTAG -> CCATGTTTAGT
TCCCACCCGGG -> CCCACCCGGGC
TCCCACGATTC -> CCCACGATTCT
TCCCACTCTCA -> CCCACTCTCAT
TCCCATTCGGT -> CCCATTCGGTA
TCCCCAATGCA -> CCCCAATGCAC
TCCCCACGTCC -> CCCCACGTCCT
TCCCCCAAGGA -> CCCCCAAGGAC
TCCCCGACTCC -> CCCCGACTCCC
TCCCGAGAGAA -> CCCGAGAGAAG
TCCCGCGAAGC -> CCCGCGAAGCT
TCCCGCTCCAC -> CCCGCTCCACA
TCCCTCCCACG -> CCCTCCCACGA
TCCGACGTCGG -> CCGACGTCGGC
TCCGATGAGGT -> CCGATGAGGTG
TCCGATTGCCG -> CCGATTGCCGT
TCCGCAGGCTG -> CCGCAGGCTGC
TCCGCCGGGAT -> CCGCCGGGATA
TCCGCTATATG -> CCGCTATATGC
TCCGGCATTGT -> CCGGCATTGTT
TCCGTACAAAT -> CCGTACAAATG
TCCGTAGTTCC -> CCGTAGTTCCA
TCCTACTCATC -> CCTACTCATCT
TCCTATGACCC -> CCTATGACCCA
TCCTCAGATAC -> CCTCAGATACA
TCCTGCTCCGC -> CCTGCTCCGCC
TCCTGGCCATT -> CCTGGCCATTT
TCCTGGCTAGC -> CCTGGCTAGCC
TCCTGTAACGT -> CCTGTAACGTT
TCCTTAGTTTT -> CCTTAGTTTTC
TCCTTTCCTGC -> CCTTTCCTGCT
TCCTTTCGAAC -> CCTTTCGAACC
TCGAACACTCG -> CGAACACTCGT
TCGAACCCGGG -> CGAACCCGGGA
TCGAACGGGAT -> CGAACGGGATT
TCGAATTGTTT -> CGAATTGTTTA
TCGACAACTCT -> CGACAACTCTC
TCGACAATGAG -> CGACAATGAGG
TCGACACGGCC -> CGACACGGCCA
TCGACACTCGA -> CGACACTCGAA
TCGACGCTGAG -> CGACGCTGAGG
TCGACTTTTCC -> CGACTTTTCCT
TCGAGCGCGGA -> CGAGCGCGGAA
TCGATCTATTG -> CGATCTATTGC
TCGCCATGGCC -> CGCCATGGCCA
TCGCCCAGCTA -> CGCCCAGCTAG
TCGCCTAGGCT -> CGCCTAGGCTG
TCGCGCGACCC -> CGCGCGACCCA
TCGCTCGTGCC -> CGCTCGTGCCG
TCGGAACGACA -> CGGAACGACAG
TCGGAGCTAAT -> CGGAGCTAATA
TCGGCTACGGC -> CGGCTACGGCA
TCGGCTCGGCT -> CGGCTCGGCTC
TCGGCTCTCCC -> CGGCTCTCCCC
TCGGGACCGGC -> CGGGACCGGCC
TCGGGCAGCAG -> CGGGCAGCAGG
TCGGTAATAGA -> CGGTAATAGAC
TCGGTGGTGAC -> CGGTGGTGACC
TCGTCATGGTG -> CGTCATGGTGA,CGTCATGGTGT
TCGTCCTACTC -> CGTCCTACTCA
TCGTCTCGCGC -> CGTCTCGCGCG
TCGTGCCGTGA -> CGTGCCGTGAT
TCGTGTAGACA -> CGTGTAGACAC
TCGTTAAAACG -> CGTTAAAACGG
TCTAACATACC -> CTAACATACCA
TCTACATCCCC -> CTACATCCCCA
TCTACCCGATG -> CTACCCGATGA
TCTACCCGGTT -> CTACCCGGTTA
TCTACGCTTAT -> CTACGCTTATC
TCTAGAGAATC -> CTAGAGAATCC
TCTATGCCCCC -> CTATGCCCCCC
TCTATTATTAT -> CTATTATTATC
TCTATTGCCAC -> CTATTGCCACC
TCTCATTTGTT -> CTCATTTGTTT
TCTCCCCGACT -> CTCCCCGACTC
TCTCGCGCGAC -> CTCGCGCGACC
TCTCGGAGCTA -> CTCGGAGCTAA
TCTCGTTAAAA -> CTCGTTAAAAC
TCTCTAGAGAA -> CTCTAGAGAAT
TCTGAGACATG -> CTGAGACATGC
TCTGGGAAACG -> CTGGGAAACGT
TCTGGTACACT -> CTGGTACACTC
TCTGTCAAGGA -> CTGTCAAGGAG
TCTGTTATCGT -> CTGTTATCGTC
TCTTATGAATG -> CTTATGAATGT
TCTTGGTCGTC -> CTTGGTCGTCT
TGAAACGCGAG -> GAAACGCGAGC
TGAAACGTAAA -> GAAACGTAAAG
TGAAAGCTACC -> GAAAGCTACCG
TGAAATAAATT -> GAAATAAATTC
TGAAATCGCTC -> GAAATCGCTCG
TGAACCCTGGG -> GAACCCTGGGC
TGAAGAAAAAG -> GAAGAAAAAGT
TGAAGGCTCAG -> GAAGGCTCAGC
TGAATATCGCC -> GAATATCGCCT
TGAATGTCCCG -> GAATGTCCCGA
TGAATGTGCCG -> GAATGTGCCGA
TGAATGTGTGC -> GAATGTGTGCT
TGACAATAATG -> GACAATAATGT
TGACCAACCAA -> GACCAACCAAT
TGACCCAGCAG -> GACCCAGCAGA
TGACCCATTGT -> GACCCATTGTC
TGACCGCGGGG -> GACCGCGGGGA
TGACCGGTGTG -> GACCGGTGTGT
TGACCTCTAAC -> GACCTCTAACA
TGACCTGTGTG -> GACCTGTGTGA
TGACGACCACG -> GACGACCACGG
TGACGGCAGGG -> GACGGCAGGGG
TGACTCATGAA -> GACTCATGAAG
TGACTGCCTTA -> GACTGCCTTAT
TGAGACATGCT -> GAGACATGCTA
TGAGCCTCCGT -> GAGCCTCCGTA
TGAGCGCCTCG -> GAGCGCCTCGA
TGAGGACACTT -> GAGGACACTTA
TGAGGGATGGG -> GAGGGATGGGC
TGAGGTAACGT -> GAGGTAACGTG
TGAGGTGTTGC -> GAGGTGTTGCT
TGAGTACGGTT -> GAGTACGGTTA
TGATATCCTGG -> GATATCCTGGC
TGATCACTCGT -> GATCACTCGTC
TGATCCCTCCC -> GATCCCTCCCA
TGATGACCCAG -> GATGACCCAGC
TGATGCTGATG -> GATGCTGATGA
TGATTAGGTCG -> GATTAGGTCGA
TGATTCCGCAG -> GATTCCGCAGG
TGATTGCAATC -> GATTGCAATCC
TGATTGCTGAT -> GATTGCTGATT
TGCAATCCGCT -> GCAATCCGCTA
TGCACAGTATA -> GCACAGTATAA
TGCACTCGAAT -> GCACTCGAATT
TGCCAACGTGC -> GCCAACGTGCT
TGCCACCCTGG -> GCCACCCTGGA
TGCCCCCCGGT -> GCCCCCCGGTA
TGCCCCGCACC -> GCCCCGCACCA
TGCCCTTGTCA -> GCCCTTGTCAC
TGCCGAGAGTG -> GCCGAGAGTGA
TGCCGTGATTG -> GCCGTGATTGC
TGCCGTTTCTA -> GCCGTTTCTAC
TGCCTGGTGAG -> GCCTGGTGAGC
TGCCTTATTTA -> GCCTTATTTAC
TGCGCGAGTCC -> GCGCGAGTCCG
TGCTAATTCGA -> GCTAATTCGAC
TGCTAGAAATT -> GCTAGAAATTA
TGCTATGACCA -> GCTATGACCAA
TGCTCACCTTC -> GCTCACCTTCT
TGCTCAGGGCT -> GCTCAGGGCTA
TGCTCCGCCGG -> GCTCCGCCGGG
TGCTGAAATCG -> GCTGAAATCGC
TGCTGACGGCA -> GCTGACGGCAG
TGCTGATGACC -> GCTGATGACCC
TGCTGATTCCG -> GCTGATTCCGC
TGCTTAAACCT -> GCTTAAACCTG
TGGAACTGTAG -> GGAACTGTAGT
TGGACCATCGG -> GGACCATCGGG
TGGACTTGCCC -> GGACTTGCCCT
TGGATAATGAT -> GGATAATGATC
TGGATGATTGC -> GGATGATTGCA
TGGATTAAACT -> GGATTAAACTA
TGGCATAGAGT -> GGCATAGAGTT
TGGCCACTGGC -> GGCCACTGGCA
TGGCCATTTCA -> GGCCATTTCAA
TGGCCCGTTTA -> GGCCCGTTTAC
TGGCCTCAATT -> GGCCTCAATTA
TGGCTAGCCTC -> GGCTAGCCTCT
TGGGAAACGTT -> GGGAAACGTTG
TGGGACGAGAA -> GGGACGAGAAG
TGGGCCCCTTT -> GGGCCCCTTTT
TGGGCGCCTCC -> GGGCGCCTCCT
TGGGGCATCTA -> GGGGCATCTAT
TGGGTCGTCAT -> GGGTCGTCATG
TGGGTTAGATC -> GGGTTAGATCC
TGGTAAAACGA -> GGTAAAACGAG
TGGTACACTCG -> GGTACACTCGA
TGGTCGTCTCG -> GGTCGTCTCGC
TGGTGAATATC -> GGTGAATATCG
TGGTGACCGGT -> GGTGACCGGTG
TGGTGAGCGCC -> GGTGAGCGCCT
TGGTGTTCCTG -> GGTGTTCCTGG
TGGTTTACCAA -> GGTTTACCAAG
TGTAACGTTGT -> GTAACGTTGTC
TGTACCTTGGA -> GTACCTTGGAC
TGTAGACACTG -> GTAGACACTGT
TGTAGTCAGTT -> GTAGTCAGTTG
TGTATTCGACA -> GTATTCGACAA
TGTCAAGGAGC -> GTCAAGGAGCG
TGTCACCCAGA -> GTCACCCAGAG
TGTCAGTATTA -> GTCAGTATTAG
TGTCAGTGTCT -> GTCAGTGTCTA
TGTCCAATAGA -> GTCCAATAGAC
TGTCCCGAGAG -> GTCCCGAGAGA
TGTCGACACTC -> GTCGACACTCG
TGTCGCCATGG -> GTCGCCATGGC
TGTCTACCCGG -> GTCTACCCGGT
TGTCTGTTATC -> GTCTGTTATCG
TGTGAAACGCG -> GTGAAACGCGA
TGTGAACCCTG -> GTGAACCCTGG
TGTGAGTACGG -> GTGAGTACGGT
TGTGCACTCGA -> GTGCACTCGAA
TGTGCCGAGAG -> GTGCCGAGAGT
TGTGCTAATTC -> GTGCTAATTCG
TGTGTGAACCC -> GTGTGAACCCT
TGTGTGCACTC -> GTGTGCACTCG
TGTGTGCTAAT -> GTGTGCTAATT
TGTTATCGTCC -> GTTATCGTCCT
TGTTCCTGGCC -> GTTCCTGGCCA
TGTTGAAAGCT -> GTTGAAAGCTA
TGTTGCTCAGG -> GTTGCTCAGGG
TGTTTAAACAC -> GTTTAAACACG
TGTTTAGTGGC -> GTTTAGTGGCC
TGTTTATCAAA -> GTTTATCAAAG
TGTTTTTATGA -> GTTTTTATGAT
TGTTTTTGCTC -> GTTTTTGCTCA
TTAAAACGGGG -> TAAAACGGGGC
TTAAACACGCG -> TAAACACGCGC
TTAAACCTGGT -> TAAACCTGGTT
TTAAACTAACT -> TAAACTAACTT
TTAAAGTAAGA -> TAAAGTAAGAC
TTAACGTCCTC -> TAACGTCCTCA
TTAATAACTTT -> TAATAACTTTT
TTAATCATATG -> TAATCATATGA
TTAATGACAAT -> TAATGACAATA
TTACACGCCCT -> TACACGCCCTC
TTACAGAGGGT -> TACAGAGGGTG
TTACCAAGAAC -> TACCAAGAACG
TTACGAGACGC -> TACGAGACGCG
TTACTCCAGAA -> TACTCCAGAAT
TTACTCCAGAC -> TACTCCAGACT
TTACTCTGAGA -> TACTCTGAGAC
TTACTGACTGC -> TACTGACTGCC
TTACTGGATAA -> TACTGGATAAT
TTAGAACAGTG -> TAGAACAGTGA
TTAGATCCATC -> TAGATCCATCC
TTAGGAGCAGT -> TAGGAGCAGTA
TTAGGCTTTCG -> TAGGCTTTCGG
TTAGGTCGATC -> TAGGTCGATCT
TTAGTGGCCTC -> TAGTGGCCTCA
TTAGTTTTCCC -> TAGTTTTCCCA
TTATAAGCTGA -> TATAAGCTGAT
TTATATGTTGA -> TATATGTTGAA
TTATCAAAGGA -> TATCAAAGGAC
TTATCACCGCT -> TATCACCGCTA
TTATCGACACG -> TATCGACACGG
TTATCGACGCT -> TATCGACGCTG
TTATCGTCCTA -> TATCGTCCTAC
TTATGAATGTG -> TATGAATGTGC
TTATGATATCC -> TATGATATCCT
TTATTAATCAT -> TATTAATCATA
TTATTATCACC -> TATTATCACCG
TTATTGTCGCC -> TATTGTCGCCA
TTATTTACTCC -> TATTTACTCCA
TTCAAGCGGAT -> TCAAGCGGATC
TTCACCGGTAC -> TCACCGGTACC
TTCACGAACTC -> TCACGAACTCG
TTCCAGATGAA -> TCCAGATGAAT
TTCCCACCCGG -> TCCCACCCGGG
TTCCGCAGGCT -> TCCGCAGGCTG
TTCCTGCTCCG -> TCCTGCTCCGC
TTCCTGGCCAT -> TCCTGGCCATT
TTCCTGTAACG -> TCCTGTAACGT
TTCGAACCCGG -> TCGAACCCGGG
TTCGACAACTC -> TCGACAACTCT
TTCGACTTTTC -> TCGACTTTTCC
TTCGAGCGCGG -> TCGAGCGCGGA
TTCGCCCAGCT -> TCGCCCAGCTA
TTCGGAACGAC -> TCGGAACGACA
TTCGGGACCGG -> TCGGGACCGGC
TTCGGTAATAG -> TCGGTAATAGA
TTCTACGCTTA -> TCTACGCTTAT
TTCTCGTTAAA -> TCTCGTTAAAA
TTCTCTAGAGA -> TCTCTAGAGAA
TTCTGGGAAAC -> TCTGGGAAACG
TTCTGGTACAC -> TCTGGTACACT
TTCTGTCAAGG -> TCTGTCAAGGA
TTCTTATGAAT -> TCTTATGAATG
TTGAAAGCTAC -> TGAAAGCTACC
TTGACCTGTGT -> TGACCTGTGTG
TTGCAATCCGC -> TGCAATCCGCT
TTGCCACCCTG -> TGCCACCCTGG
TTGCCCTTGTC -> TGCCCTTGTCA
TTGCCGTTTCT -> TGCCGTTTCTA
TTGCCTGGTGA -> TGCCTGGTGAG
TTGCTCACCTT -> TGCTCACCTTC
TTGCTCAGGGC -> TGCTCAGGGCT
TTGCTGATTCC -> TGCTGATTCCG
TTGCTTAAACC -> TGCTTAAACCT
TTGGACCATCG -> TGGACCATCGG
TTGGCCCGTTT -> TGGCCCGTTTA
TTGGGGCATCT -> TGGGGCATCTA
TTGGGTTAGAT -> TGGGTTAGATC
TTGGTCGTCTC -> TGGTCGTCTCG
TTGTATTCGAC -> TGTATTCGACA
TTGTCACCCAG -> TGTCACCCAGA
TTGTCCAATAG -> TGTCCAATAGA
TTGTCGACACT -> TGTCGACACTC
TTGTCGCCATG -> TGTCGCCATGG
TTGTGAGTACG -> TGTGAGTACGG
TTGTTTAAACA -> TGTTTAAACAC
TTGTTTATCAA -> TGTTTATCAAA
TTGTTTTTGCT -> TGTTTTTGCTC
TTTAAACACGC -> TTAAACACGCG
TTTAAAGTAAG -> TTAAAGTAAGA
TTTAACGTCCT -> TTAACGTCCTC
TTTACAGAGGG -> TTACAGAGGGT
TTTACCAAGAA -> TTACCAAGAAC
TTTACGAGACG -> TTACGAGACGC
TTTACTCCAGA -> TTACTCCAGAA
TTTAGTGGCCT -> TTAGTGGCCTC
TTTATCAAAGG -> TTATCAAAGGA
TTTATGATATC -> TTATGATATCC
TTTATTGTCGC -> TTATTGTCGCC
TTTCAAGCGGA -> TTCAAGCGGAT
TTTCCCACCCG -> TTCCCACCCGG
TTTCCTGCTCC -> TTCCTGCTCCG
TTTCCTGTAAC -> TTCCTGTAACG
TTTCGAACCCG -> TTCGAACCCGG
TTTCGGAACGA -> TTCGGAACGAC
TTTCGGGACCG -> TTCGGGACCGG
TTTCTACGCTT -> TTCTACGCTTA
TTTGACCTGTG -> TTGACCTGTGT
TTTGCTCACCT -> TTGCTCACCTT
TTTGGGGCATC -> TTGGGGCATCT
TTTGTATTCGA -> TTGTATTCGAC
TTTGTTTAAAC -> TTGTTTAAACA
TTTTAAAGTAA -> TTTAAAGTAAG
TTTTACAGAGG -> TTTACAGAGGG
TTTTATGATAT -> TTTATGATATC
TTTTCCCACCC -> TTTCCCACCCG
TTTTCCTGTAA -> TTTCCTGTAAC
TTTTCGGAACG -> TTTCGGAACGA
TTTTGACCTGT -> TTTGACCTGTG
TTTTGCTCACC -> TTTGCTCACCT
TTTTTATGATA -> TTTTATGATAT
TTTTTGCTCAC -> TTTTGCTCACC
